basket	cop
belt	ca
bat	wat
channel	luk
count	lop
blind	tapa
brains	mina
canoe	ro
afraid	lat
forbid	kono
egg	mula
adze	wolo
hill	burin
water	ino
bail out	raic
ancient	ar tam
fly	ɲipa
current	car/at
cave	poŋ
neck	loŋo
