Arvanitic	A
when	nu
at	te
of	i
mulberry	man
oath	be
harbor	port
skewer	hell
thing	send
March	mars
my	mi
Tosk	pi
womb	an
fortune telling	fall
sheath	mill
of	all
swim	not
stinger	thumb
surprise	habit
cosmonaut	astronaut
final	finale
ash	hi
so	abolla
exit	del
dawn	ag
he	ai
bacterium	bakter
she	ajo
dog	bal
arch	ver
rivulet	she
say	them
Gheg	re
had	pata
eye	sy
arrow	ber
steamboat	vapor
pond	bend
convince	bind
deep	fell
brawl	grind
jujube	hide
acorn	lend
mount	mal
heart	shat
exclamation	bi
today	sot
cake	kek
lock	dry
son	bir
people	lem
thirst	et
laugh	tall
drawing	short
lighthouse	far
hair	push
evil	lig
and	e
horizontal	horizontal
participle	duke
Arvanitic	d
strawberry tree	mare
veil	kith
roadside	han
deaf	eng
beech	ah
eat	ha
fern	fier
sprout	bij
now	ni
dissolve	tres
three	tre
weather	mot
exit	dal
religion	fe
we	ne
we	na
how	si
gold	ar
some	ca
you	ti
that	se
mill	pot
two	dy
yes	po
it	ra
without	pa
dirty	pis
three	tri
pant leg	tu
thread	pe
fill	pik
the	baba
thicken	trash
armour	armor
exactly	bash
ram	dash
Daniel	Daniel
basin	legen
struck	tap
shepherd	bari
their	tyre
totally	fare
Basque	Baske
you	don
cigarette	cigare
money	pare
dusk	mug
bre	more
field	log
trough	lug
there is	ska
ball	top
bull	dem
facial	nur
slave	rob
this	ky
you	ty
kid	edh
belly	bark
bow	hark
be	jam
raft	trap
don't	mos
friend	mik
us	neve
draft	aft
god	ago
alarm	alarm
shepherd's vest	shark
have	kam
ready	gati
Bosnian pine	arti
movie	film
hotel	hotel
how much	sa
old	ane
chase	ish
then	ani
boom	bum
chess	shah
castle	kala
north	veri
foundation	term
Italy	Italia
whim	trill
get	hyp
hut	bun
-ësor	-or
I	has
hut	stan
but	por
tendon	dell
end	fund
southern	lab
thin	aba
abbacy	abaci
mole	lez
sea	det
millet	mel
let	le
telephone	telefon
nephew	nip
cat	mace
brand	trink
middle	mes
Adam	Adam
ford	va
rabbit	mag
beam	tra
shoulder	sup
mathematical	matematik
suffix	-a
political	politik
seacoast	mat
drinker	pijan
bus	autobus
bite	dang
flu	grip
yak	jak
email	postel
place	vend
get	hip
C	Ç
full	plot
Gjakova	qen
ebony	abanoz
abbot	abat
abdication	abdikim
abdicate	abdikoj
ABC	abece
ABC	abetare
subscription	abonim
subscribe	abonohem
subscriber	abonuar
abrogation	abrogim
abrogate	abrogoj
absolute	absolut
absolutely	absolutisht
absolutism	absolutizëm
absorption	absorbim
absorb	absorboj
absenteeism	abstenim
abstain	abstenoj
absentee	abstenonjës
abstract	abstrakt
absurdity	absurditet
abuse	abuzim
abuse	abuzoj
bitter	acar
aggravate	acaroj
acidity	aciditet
accommodate	adaptoj
namesake	adash
access	aderim
associate	aderoj
custom	adet
adoration	adhurim
adore	adhuroj
adorer	adhuronjës
admirer	adhurues
admirer	adhuruese
absorbing	adhurueshëm
administration	administratë
administrative	administrativ
administration	administrim
administer	administroj
manager	administronjës
admiration	admirim
admire	admiroj
admirer	admironjës
admirable	admirueshëm
adoption	adoptim
adopt	adoptoj
address	adresë
address	adresoj
aerodynamic	aerodinamik
aerodynamics	aerodinamikëm
aeroplane	aeroplan
airport	aeroport
period	afat
at	afër
close	afërm
certainly	afërmënç
intimacy	afërsi
about	afërsisht
affinity	afinitet
affirm	afirmoj
notice	afishë
placard	afishoj
African	afrikan
well	pus
author	autor
blade	teh
present	-na
suffixed	-u
i	vet
male	lush
pattern	model
pour	lys
remedies	prime
trouble	hall
plough	plug
willingness	hir
ember	ur
boron	bor
tip	pic
no	jo
Gheg	cull
butt	poligon
alphabet	alfabet
testicles	bole
open	hap
laurel	lar
death	mort
cry	pall
behind	pas
lead	plumb
heap	tog
place	vis
razor	brisk
I	fend
furrow	hep
slurp	lap
tear	lot
bunch	vile
stuff	tend
Adverb	-t
dad	babi
adjective	adjektiv
hedgehog	esh
shortsighted	pec
elder	bac
precipitate	resh
floor	kat
sharpen	eh
throw	flak
mill	mulli
where	ku
sex	seks
author	autore
poison	helm
rough	hum
soak	meh
neck	gush
shelf	raft
China	Kina
patronymic	Pali
Iraq	Irak
alas	bobo
limb	mis
chaffinch	bors
empty	bosh
hornless	gul
south	jug
banana	banane
separately	s-
soul	ze
king	rig
dark	murg
suffixed	-i
verb	-j
tungsten	volfram
hi	tung
trumpet	bori
Albania	Shqipëria
niobium	niob
precursor	pris
stick	kall
news	haber
forest	pyll
young	ri
dark	err
behind	ith
mediopassive	-het
penis	bile
on	heri
active	aktiv
now	tash
vagina	pill
husband	burr
male	dac
hang	var
die	zar
autonomous	autonom
pubic hair	pubis
ox	ka
dance	valle
small	vol
but	ama
mediopassive	-et
flesh	mish
elephant	elefant
Arvanitic	α
encore	bis
sodium	natrium
hello	tungjatjeta
Albanian	shqip
sessile oak	bung
camel	deve
man	trim
Europe	Evropa
vite	vit
thread	tel
Albanian	a
Arvanitic	D
day	Dita
potassium	Kalium
female	Ora
Arvanitic	Z
Albanian	Α
inula	oman
mal	mali
don't	mo
chain	lak
shadow	abe
rope	litar
Islamic	islam
cattle	haje
Basque	bask
automobile	automobil
dwarf	herr
Gheg	graf
Brown	ame
scream	brit
post	hu
parliament	parlament
lek	qintar
go	iki
chewing gum	çamçakëz
ballet	balet
eagle	orr
Japan	Japonia
stretcher	vig
actor	aktor
marijuana	marihuana
exclamation	bre
Turk	turk
remain	jes
sweat	djersë
coast	breg
horizon	horizont
parcel	pako
pepper	spec
agony	mund
after	pasi
artist	artiste
party	parti
jail	burg
Gheg	plori
make	fic
dolphin	delfin
after	nes
wall	zid
Buddha	Buda
airport	aerodrom
astronomer	astronom
assistant	asistente
they	ato
financial	financiar
mine	imi
joy	gaz
cow	lopë
bear	ari
measure	mas
monkey	majmun
scrub	kore
finch	fink
squirrel	ger
treasure	visar
Arvanitic	Β
Arvanitic	β
doctor	doktor
belly	bak
bear	lind
rush	flug
drug	barna
Arvanitic	Γ
kettle	kazan
Arvanitic	γ
Arvanitic	δ
Arvanitic	ε
Arvanitic	ζ
Arvanitic	Ε
Arvanitic	Δ
they	ata
corner	cep
nightmare	ang
të	ikura
apricot	kajsi
hurricane	uragan
highway	drom
rain	shi
pull	tras
big	dak
stick	stap
warm	vak
Taurus	Demi
numb	pitas
foal	mëz
mud	baltë
chisel	daltë
request	lus
nitrogen	azot
horn	bri
yogurt	kos
umbrella	çadër
umbrella	ombrellë
prison	haps
threshold	prag
anise	anason
give	jap
incite	grah
pledge	peng
vein	damar
grab	kap
far	tej
penis	kar
forgive	fal
Negro	harap
frighten	tus
bend	kul
when	kur
Armenian	armen
payment	hak
or	ose
rite	rit
nit	arg
clan	fis
women	gra
woman	grua
region	harc
bey	bej
ink	mellan
fallow	ugar
according	sipas
mate	boj
humid	rij
middle	mez
give	lej
object	trup
sit down	ul
mason	usta
steel	çelik
misfortune	kob
cubit	kut
chance	rast
gunpowder	barut
not	nuk
tobacco	duhan
bamboo	bambu
now	tani
give	jep
ice	akull
iron	hekur
walnut	arrë
tree	dru
flour	miell
vinegar	uthull
donkey	gomar
hand	dorë
sun	diell
raven	korb
dark	terr
acorn	lende
brain	tru
sheep	dele
barley	elb
heap	grumbull
grave	varr
master	zot
silver fir	bren
takes	merr
cut	pret
mud	lym
mud	llum
sky	qiell
pus	qelb
pig	derr
star	yll
hundred	qind
steam	avull
mourn	kuku
pit	gropë
stream	lise
there	aty
anise	raki
freedom	liri
white	bardhë
lip	buzë
owl	buf
fence	gardh
half	gjysmë
neck	qafë
black	zi
thorn	gjemb
shit	mut
far	larg
dung	bajgë
dark	murgash
chaff	byk
beautiful	bukur
crow	sorrë
peak	çukë
doe	sutë
hornless	shyt
trunk	kopaç
rainbow	ylber
elbow	bërryl
belt	brez
cap	kësulë
tick	këpushë
village	katund
flute	flojere
pipe	fyell
quickly	flutur
crumb	thërrime
claw	kthetër
scops owl	gjon
gjyshër	gjysh
whetstone	grihë
gluttonous	hamës
esophagus	gurmaz
demolish	dërmoj
trap	kurth
pod	bishtajë
duck	rosë
buttermilk	dhallë
donkey	magar
he-goat	cjap
lid	kapak
crooked	shtrembër
fireplace	vatër
ladle	pehar
there	tek
dictionary	fjalor
alas	bubu
time	vakt
gait	ling
green	gjelbër
dear	loc
April	prill
moron	debil
virtue	duk
to	deri
tsetse	cece
sheep	berr
request	lut
his	tij
Russian	rus
dig	mih
patronymic	Martini
flag	lon
strong	dreng
love	dashuri
nominative	nominativ
dative	dativ
row	varg
envelope	zarf
newbie	nub
ablative	ablativ
portmanteau	baule
thread	nus
curly	kaçurrel
mind	mên
incense	kem
cube	kub
manganese	mangan
me	mua
rim	vang
river	lum
mass	plim
farmer	arar
wrist	dore
godchild	fijan
trick	hile
skeleton	skelet
one	një
gruel	pite
shame	marre
go	vete
incline	prier
dry up	thaj
atheist	ateist
am	muj
harvest	korr
university	universitet
seven	shtatë
grater	rende
sediment	dra
eggs	gren
stove	porr
fever	ethe
Tosk	pidh
is	â
rope	rade
unripe	muf
month	muaj
week	javë
day	ditë
minute	minutë
second	sekondë
chair	sandali
stagnation	amulli
medicine	ilaç
sugar	sherbet
shake	tund
antimony	antimon
ask	pyes
catkin	gath
I	cac
bison	bizon
animal	mang
filch	picas
apostrophe	apostrof
Gheg	bô
you	ju
anatomy	anatomi
spider	merimangë
zoologist	zoolog
biologist	biolog
oriole	beng
vampire	vampir
lion	luan
to	rys
porcelain	bilur
bird	zog
blessing	bekim
insert	fus
hunger	uri
e	Republika e Shqipërisë
so much	aq
Albanian	Evgit
old	plak
sheet metal	saç
touch	çek
shepherd	çoban
scab	pah
bromine	brom
Coffea	kafe
automaton	automat
hollow	fyl
lantern	fener
synonym	sinonim
antonym	antonim
go	bares
lancet	bisturi
tomato	domate
together	avari
artery	arterie
testicles	bolle
astronomy	astronomi
pale	e celet
biography	biografi
sacrifice	fli
condom	prezervativ
wealth	pasuri
parasite	parazit
modesty	modesti
athlete	atlete
own goal	autogol
economy	ekonomi
fork	pirun
autonomy	autonomi
shame	korit
cut	ther
scythe	kosë
sickle	drapër
potpourri	potpuri
key	çelës
regard	sodit
Joseph	Josef
apple	mollë
force	takat
king	mbret
queen	mbretëreshë
attribute	veti
cili	ç'
tray	tepsi
cause	motiv
mom	mami
island	ishull
juice	lëng
ant	milingonë
heavy	rëndë
nose	hundë
plant	bimë
saliva	pështymë
house	shtëpi
law	ligj
Gheg	rërë
I	shkruaj
shield	mburojë
comb	krehër
good	mirë
scorpion	akrep
time	nge
maple	panjë
husband	burrë
die	vdes
giving	marrë
war	luftë
dream	ëndërr
dough	brumë
boot	çizme
vise	morsë
mud	llom
cliff	shkëmb
finger	gisht
basket	shportë
ditch	hendek
hole	vrimë
crab	gaforre
grape	rrush
fruit	frutë
decision	vendim
pleasure	kënaqësi
what	çfarë
which	cili
who	kush
everything	gjithçka
everything	çmos
what	çka
maize	misër
maize	kallamboq
cup	filxhan
coffin	qivur
coffin	arkivol
night	natë
seed	farë
sort	soj
name	emër
hope	shpresë
cemetery	varrezë
lynx	rrëqebull
moisture	lagështirë
boat	varkë
hoof	thundër
spot	pikas
afternoon	pasdrekë
horse	kalë
fire	zjarr
chin	mjekër
trunk	trung
hit	godas
self	vetë
flea	plesht
book	libër
path	shteg
cottage	visele
bread	bukë
alder	verr
winter	dimër
spring	pranverë
autumn	vjeshtë
go	futem
bell	zile
century	centurie
woodworm	kri
them	atyre
homeland	mëmëdhe
atheism	ateizëm
atelier	atelie
grandfather	babagjysh
then	atëherë
fatherhood	atësi
him	atij
thither	andej
athlete	atlet
athletic	atletik
dark	errët
athletics	atletikë
atmosphere	atmosferë
attribute	atribut
atrophy	atrofi
trump	atu
yonder	atje
at once	përnjëherësh
immediately	menjëherë
anemia	anemi
audience	audiencë
soldier	ushtar
officer	oficer
officer	nënpunës
atlas	arrëz
autograph	autograf
combine	autokombajnë
automatic	automatik
throat	fyt
Adam's apple	molla e Adamit
atlas	arrëza e fytit
sock	çorap
investigation	hetim
chair	karrige
street	rruge
glass	gotë
window	dritare
cheek	faqe
belt	rrip
bachelor	beqar
broken	harmi
free	falas
Denmark	Danimarka
stranger	huaj
alien	jashtëtokësor
aristocracy	aristokraci
army	armatë
army	ushtri
arrive	arrij
arrive	vij
cattle	bagëti
gardener	kopshtar
gardener	kopshtare
dizziness	marramendje
almond	bajame
regard	kujdes
vocative	vokativ
grey	gri
system	sistem
homonym	homonim
bayonet	bajonetë
axe	sëpatë
beer	birrë
behind	prapa
blood	gjak
breath	frymëmarrje
breath	frymë
burn	djegje
peshk	peshk i kuq
government	qeveri
ivy	dredhkë
island	ujdhesë
jackal	çakall
jackal	çakalle
tall	gjatë
grocer	bakall
seller	shitës
hammer	çok
principle	parim
accusative	akuzativ
locative	lokativ
chlorine	klor
give	ap
theirs	tyri
countryside	zdar
acetylene	acetilen
acrobat	akrobat
assistant	asistent
cricket	kriket
passive	pasiv
chord	akord
abdest	abdes
activist	aktivist
box	kuti
tool	hallat
phoenix	feniks
not	s'
smell	nuhat
autocrat	autokrat
scandal	skandal
abacus	abak
practice	zakon
hew	kep
add	thar
patronymic	-aj
Albanian	afrona
barn	pleme
genital	ples
woodpigeon	vito
highlander	malas
fish	peshk
Israeli	izraelit
English	anglisht
silver	argjend
water	ujë
girl	vajzë
weapon	armë
arm	armatos
maternal uncle	dajë
older	bacë
bee	bletë
copper	bakërt
copper	bakër
copper	bakëre
arable	arë
mallet	çekiç
make	topit
reduce	mej
archaeologist	arkeolog
archaeologist	arkeologe
archaeology	arkeologji
autopsy	autopsi
flower	lule
advance	avancoj
advance	avancim
advance	avancë
ambulance	autoambulancë
garden	kopsht
apathetic	apatik
spontaneous	spontan
aviation	aviacion
lighter	çakmak
artillery	artileri
painter	ballamar
shadow	hije
knee	gju
milk	qumësht
equilateral	barabrinjës
lampshade	abazhur
kiss	puthje
pull	krej
snow	borë
Arabic	arab
do-	n-
frog	bretkosë
fruit tree	pemë
stone	gur
lake	liqen
hot	nxehtë
cold	ftohtë
cave	shpellë
sister	motër
smoke	tym
chicken	pulë
school	shkollë
food	ushqim
leaf	gjethe
mother	nënë
pornographer	pornograf
pornography	pornografi
authority	autoritet
prime	vlug
native	autokton
big sister	tota
rheum	sklep
clod	mys
moss	myshk
hope	shpresoj
arm	krah
word	fjalë
luggage	bagazh
attraction	atraksion
clout	arnë
barricade	barrikadë
flat	bemol
bacteriology	bakteriologji
boomerang	bumerang
apogee	apogje
attaché	atashe
pillar	shtyllë
Santa Claus	Baba Dimri
complicity	bashkëfajësi
atavism	atavizëm
arthritis	artrit
ballad	baladë
arsenic	arsenik
holiday	kremte
crane	vinç
I	kij
Gibraltar	Gjibraltari
break	thyej
hill	kodër
bless	bekoj
shovel	lopatë
city	qytet
hymn	himn
hydra	kuçedër
choose	zgjedh
Kosovo	Kosovë
accomplice	bashkëfajtor
lady	zonjë
sweet	ëmbël
lawyer	avokat
holy	shenjtë
somewhere	kund
heart	zemër
aluminum	alumin
wind	erë
road	rrugë
ship	anije
Belgian	belgjian
frog	zhabë
advantage	avantazh
wasp	arëz
forehead	ballë
teacher	arsimtar
teacher	arsimtare
arteriosclerosis	arteriosklerozë
meet	takoj
Arctic	arktik
battalion	batalion
archaeological	arkeologjik
banknote	bankënotë
dragon	dragua
physical	fizik
tripe	bumbar
hostile	armiqësor
weed	harr
pullover	mitan
letter	shkronjë
paper	letër
cheese	djathë
baroness	baroneshë
neutralize	asnjanësoj
dog	langua
wound	lëndim
hatred	urrejtje
library	bibliotekë
gypsy	arixhi
bran	hime
sword	shpatë
Aristotle	Aristoteli
ghost	fantazmë
rifle	pushkë
battle	betejë
death	vdekje
luck	fat
bifurcation	bigëzim
apocalypse	apokalips
paradox	paradoks
star	hyll
four	katër
wolf	ujk
wolf	ulk
galaxy	galaktika
man	njeri
precious	vyer
eel	ngjalë
Sweden	Suedia
dear	loke
potassium	kaliumi
example	shembull
mildew	vrug
breathe	marr frymë
present	-em
cotton	ind
a	a flet anglisht
wagon	kerr
tongue	gjuhë
furrow	brazdë
mirë	mirë u pafshim
prey	pre
result	rezultat
hydrate	hidrat
radiologist	radiolog
ankle	noçkë
possible	mundur
calligraphy	bukurshkrim
punch	bularës
drone	buçallë
cricket	bulkth
African	afrikane
candidate	kandidat
start	nis
how are you	si jeni
how are you	qysh je
dhembje	dhembje koke
shoe	këpucë
bottle	shishe
bag	qese
square	katror
triangle	trekëndësh
drudgery	angari
erotic	erotik
historical	historik
milli-	mili-
bravo	aferim
bypass	anashkaloj
arrest	arrestoj
annihilate	asgjësoj
sharpen	grih
dialect	dialekt
typical	tipik
dissolve	tret
change	kusur
whither	venit
abyss	abis
greke	grek
glossary	fjalorth
bookshop	librari
smile	buzëqeshje
smile	buzëqesh
mister	zotëri
surprised	habitor
to	umas
beryllium	berilium
hers	saji
mister	zotëni
europium	europ
flesh	tul
grab	marr
nightmare	ankth
ambassador	bajloz
buoy	bovë
cytology	citologji
cuckold	brinar
budget	buxhetor
budget	buxhet
caesura	cezurë
it	buron
twenty	-zet
lepuri	lepuri i egër
lepur	lepur i gropave
chain	zinxhir
tortoise	breshkë
salt	kripë
calcium	kalcium
nightingale	bilbil
buffalo	buall
caesium	cezium
unicorn	briqen
bulldozer	buldozer
public	publik
architect	arkitekt
time	vade
shop	dyqan
onions	qepë
aristocrat	aristokrat
patriot	atdhetar
farmer	bujk
joke	shaka
be-	z-
independent	lirë
six	gjashtë
climb	hipi
press	trys
pimple	puçërr
drawer	fluer
blind	verbër
understand	kuptoj
order	porosi
Libra	Peshorja
Virgo	Virgjëresha
virgin	virgjëreshë
depression	mërzi
bëj	bëj seks
semen	spermë
raise	ngritje
masturbate	masturboj
nipple	thithkë
I	bëj
kill	vras
orgy	orgji
sugar	sheqer
sexuality	seksualitet
masculine	mashkullor
deaf	shurdh
deaf	shurdhët
deafened	shurdhuar
deafen	shurdhoj
snake	gjarpër
brother	vëlla
cheers	gëzuar
joy	gëzoj
fog	mjegull
angel	ëngjëll
help	ndihmë
help	ndihmoj
dream	ëndërroj
beauty	bukuri
simple	thjeshtë
I	fsheh
Cancer	Gaforrja
moon	hënë
desire	dëshiroj
desire	dëshirë
lust	epsh
rigid	paepshëm
linguistic	gjuhësor
linguistics	gjuhësi
multilingual	shumëgjuhësh
bilingual	dygjuhësh
bilingualism	dygjuhësi
gjuhë	gjuhë e nënës
testicle	testikul
ocean	oqean
bored	mërzitur
carry	mbar
orgasm	orgazmë
pederasty	pederasti
soot	blozë
fondle	josh
hunt	gjuaj
son	dhampir
consonant	-s-
moment	çast
flag	flamur
air	ajër
ticket	biletë
season	stinë
waistcoat	jelek
boy	djalë
colleague	koleg
colleague	kolege
color	ngjyrë
friend	shok
female	shoqe
suitcase	valixhe
border	kufi
teach	mësoj
rose	trëndafil
dove	pëllumb
the	pëllumbi
watermelon	bostan
nest	fole
un-	pa-
boar	gak
your	yt
dormouse	gjer
oakum	krybe
Macedonian	arne
circumcision	synet
utterance	folje
quarter	çerek
bobtailed	cub
weave	vej
difference	ndryshim
hammer	çekan
hydrogen	hidrogjen
nude	lakuriq
nudity	lakuriqësi
-ism	-ësi
strange	çuditshëm
organise	organizoj
rationalize	arësyetoj
propose	propozoj
enemy	armik
bushel	çereke
bushel	çerekore
irony	ironi
international	ndërkombëtar
national	kombëtar
vodka	vodkë
entomology	entomologji
I	shoh
hide and seek	çelembyll
simplicity	thjeshtësi
coldness	ftohtësi
heat	nxehtësi
simplify	thjeshtëzoj
lesser celandine	buzëmadhe
nest	çerdhe
unleavened	kulaç
psychologist	psikolog
gossip	çuçurjar
gossip	çuçurimë
nostrils	feje
the	grima
maternal aunt	teze
prison	quar
unusually	jashtëzakonisht
hut	prosek
horned	brinor
unusual	jashtëzakonshëm
unknown	panjohur
isolate	veçoj
co-	bashkë-
cooperate	bashkëpunoj
make	kënaq
grammar	gramatikë
lustful	epshor
nationwide	mbarëkombëtar
maybe	ndoshta
at	nga
bed	shtrat
music	muzikë
honey	mjaltë
sound	tingull
skill	aftësi
able	aftë
culture	kulturë
entirety	tërësi
eastern	lindor
western	perëndimor
northern	verior
southern	jugor
suck	thith
risk	rrezikoj
dung beetle	bubuzhel
cage	kafaz
towel	peshqir
the	Afërdita
think	mendoj
divine	hyjnor
sing	këndoj
syphilis	tesh
famous	shquar
mix up	ndërlikoj
vibrate	dridhem
true	vërtetë
century	shekull
song	këngë
scrotum	skrotum
masturbation	masturbim
sweat	djersij
decide	vendos
discover	zbuloj
discovery	zbulim
perfect	përsos
perfect	përsosur
awake	zgjuar
shame	turp
forget	harroj
forgettable	harrueshëm
unforgettable	paharrueshëm
coexist	bashkëjetoj
coexistence	bashkëjetesë
collaboration	bashkëpunim
event	ndodhi
coincidence	bashkëndodhi
interact	bashkëveproj
interaction	bashkëveprim
action	veprim
pull out	qis
eyelash	qerpik
skin	lëkurë
masturbate	masturbohem
eagle	shqiponjë
swan	mjellmë
graph	grafik
sometimes	ndonjëherë
qese	qese e herdheve
number	numër
give up	dorëzohem
vrimë	vrimë e zezë
mediopassive	afrohem
get	hidhërohem
different	ndryshëm
difficult	vështirë
për	për shembull
explain	sqaroj
explanation	sqarim
speak	flas
me	mësohem
bride	nuse
calm	rehat
hat	kapelë
pomegranate	shegë
glass	xham
mosque	xhami
laborer	argat
improve	përmirësoj
root	rrënjë
moth	molë
pole	shtagë
permission	leje
threadworm	rra
wool	lesh
eggplant	patëllxhan
crack	plas
pie	byrek
Arvanitic	Ƃ
banquet	dars
thank you	faleminderit
echo	jeh
louse	morr
state	shtet
stale	bajat
grind	bluaj
reason	arsye
ice cream	akullore
pea	bizele
archipelago	arkipelag
fava bean	bathë
basil	borzilok
Pacific Ocean	Oqeani Paqësor
same	binjak
poster	afishe
brown	bojëkafe
article	artikull
biology	biologji
side	anë
beret	beretë
escape	arratisem
arrival	arritje
architecture	arkitekturë
enter	ryj
artistic	artistik
fragrance	aromë
chatter	bërbëlit
chatter	bërbëlitje
fugitive	arratisur
rub	brij
handicraft	artizanat
basement	bodrum
interest	interes
partner	ortak
there	tutje
Argentinian	argjentinas
educate	arsimoj
balance	bilanc
bitumen	bitum
straw	biule
bachelorhood	beqari
painter	bojaxhi
pass	kaloj
biographer	biograf
sheaves	duaj
sweaty	djersitur
aspirin	aspirinë
clay	argjilë
blueberry	boronicë
archaic	arkaik
Armenian	armenisht
Armenian	armenishte
Tallinn	Talin
biochemistry	biokimi
shit	dhjes
meadow	livadhe
speed	shpejtësi
marry off	martoj
alarm	alarmoj
swim	notoj
gunsmith	armëndreqës
gunsmith	armëpunues
publish	botoj
daughter	bijë
beast	bishë
i	Mali i Zi
stay	rri
ass	bythë
early	lashtë
lick	lëpij
visible	dukshëm
invisible	padukshëm
size	madhësi
energy	energji
world	botë
bag	çantë
misfortune	fatkeqësi
unfortunate	fatkeq
mouth	gojë
thing	gjë
sort	lloj
way	mënyrë
play	luaj
rub	fërkoj
car	makinë
armpit	sqetull
skull	kafkë
buttock	prapanicë
muscle	muskul
face	fytyrë
pornographic	pornografik
republic	republikë
science	shkencë
colorful	shumëngjyrësh
translate	përkthej
translation	përkthim
physics	fizikë
astrophysics	astrofizikë
light	dritë
shark	peshkaqen
whale	balenë
boycott	bojkotoj
boycott	bojkotim
take	shpie
paint	lyej
called	quhem
believe	besoj
I	shkërdhej
navel	kërthizë
barber	berber
democracy	demokraci
monarchy	mbretëri
scientific	shkencor
organism	organizëm
starry	yjeplotë
goldsmith	arpunues
woman	xitelë
biological	biologjik
crest	lafshë
urethra	uretër
jealousy	xhelozi
jealous	xheloz
damage	dëmtoj
region	rajon
news	lajm
specific	veçantë
të	mëdha
të	mëdhenj
e	madhe
Albanian	shqiptar
poor	varfër
endless	pafund
wet	lagët
small	vogël
bad	keq
flexible	epshëm
flexibility	epshmëri
amphibian	amfib
Mediterranean Sea	Deti Mesdhe
arithmetic	aritmetikë
suffer	vuaj
hew	qij
freeloader	qylaxhi
five	pesë
eight	tetë
nont	nëntë
ten	dhjetë
eleven	njëmbëdhjetë
twelve	dymbëdhjetë
thirteen	trembëdhjetë
fourteen	katërmbëdhjetë
fifteen	pesëmbëdhjetë
sixteen	gjashtëmbëdhjetë
seventeen	shtatëmbëdhjetë
eighteen	tetëmbëdhjetë
nineteen	nëntëmbëdhjetë
twenty	njëzet
twenty-one	njëzetenjë
twenty-two	njëzetedy
twenty-three	njëzetetre
twenty-four	njëzetekatër
twenty-five	njëzetepesë
twenty-six	njëzetegjashtë
twenty-eight	njëzetetetë
twenty-seven	njëzeteshtatë
twenty-nine	njëzetenëntë
thirty	tridhjetë
thirty-one	tridhjetenjë
thirty-two	tridhjetedy
thirty-three	tridhjetetre
thirty-four	tridhjetekatër
thirty-five	tridhjetepesë
thirty-six	tridhjetegjashtë
thirty-seven	tridhjeteshtatë
thirty-eight	tridhjetetetë
thirty-nine	tridhjetenëntë
forty	dyzet
forty-one	dyzetenjë
forty-two	dyzetedy
forty-three	dyzetetre
forty-four	dyzetekatër
forty-five	dyzetepesë
forty-six	dyzetegjashtë
forty-seven	dyzeteshtatë
forty-eight	dyzetetetë
forty-nine	dyzetenëntë
fifty	pesëdhjetë
apiculture	bletari
universe	gjithësi
laugh	qesh
protect	mbroj
I	blej
cry	qaj
walk	eci
crawl	zvarrisem
friendship	miqësi
become	miqësohem
muscular	muskulor
muscular	muskuloz
microbiology	mikrobiologji
mycology	mikologji
virology	viriologji
pathology	patologji
fifty-one	pesëdhjetenjë
fifty-two	pesëdhjetedy
fifty-three	pesëdhjetetre
fifty-four	pesëdhjetekatër
fifty-five	pesëdhjetepesë
fifty-six	pesëdhjetegjashtë
fifty-seven	pesëdhjeteshtatë
fifty-eight	pesëdhjetetetë
fifty-nine	pesëdhjetenëntë
sixty	gjashtëdhjetë
sixty-one	gjashtëdhjetenjë
sixty-two	gjashtëdhjetedy
sixty-three	gjashtëdhjetetre
sixty-four	gjashtëdhjetekatër
sixty-five	gjashtëdhjetepesë
sixty-six	gjashtëdhjetegjashtë
sixty-seven	gjashtëdhjeteshtatë
sixty-eight	gjashtëdhjetetetë
sixty-nine	gjashtëdhjetenëntë
tattoo	tatuazh
musculature	muskulaturë
bodily	trupor
undress	zhvishem
undress	zhvesh
work	punoj
cock	kokosh
entertainment	argëtim
anarchism	anarkizëm
ethnic	etnik
grammarian	gramatikan
grammatically	gramatikisht
grammatical	gramatikor
died	vdekur
also	gjithashtu
reptile	zvarranik
messy	rrëmujaxhi
goodness	mirësi
a	deng
moisten	njom
clean	pastroj
mathematician	matematikan
chaffinch	borës
shirt	këmishë
New Year	Viti i Ri
nutcracker	arrëthyese
embankment	argjinaturë
she-bear	arushë
infected	kath
something	diçka
file down	ath
hell	ferr
between	midis
hierarchy	hierarki
that	taç
rock	batoj
interstellar	ndëryjor
bicycle	biçikletë
bike shop	biçikletari
bicycle	biçikletar
point	cip
February	fror
Albanian	kanun
opening	hapje
scale	kandar
celebrate	festoj
Indonesia	Indonezia
bomb	bombë
hornless	bosk
female	femër
physiologist	fiziolog
Arbëresh	nesër
education	arsim
emptiness	boshllëk
long	lutem
head	kokë
telephone	telefonoj
butter	gjalpë
market	treg
kernel	koqe
prostitute	kurvë
peaceful	paqësor
custom	doke
irrigation	kapt
Pristina	Prishtinë
backwards	vervele
prow	plor
stammering	belbëzim
peace	paqe
boric	borik
justify	arsyetoj
breast	cicë
artesian	artezian
stray	arrakat
plait	thur
bisexuality	biseksualitet
heterosexuality	heteroseksualitet
homosexuality	homoseksualitet
Adam	Adem
bashkëveprim	bashkëveprim thelbësor
fundamental	thelbësor
weak nuclear interaction	bashkëveprimi i dobët bërthamor
weak nuclear force	forca e dobët bërthamore
strong nuclear interaction	bashkëveprimi i fortë bërthamor
electromagnetic interaction	bashkëveprimi elektromagnetik
gravitational interaction	bashkëveprimi gravitacional
forcë	forcë thelbësore
force	forcë
strong interaction	bashkëveprimi i fortë
strong force	forca e fortë
nuclear	bërthamor
strong nuclear force	forca e fortë bërthamore
weak force	forca e dobët
weak interaction	bashkëveprimi i dobët
electromagnetic force	forca elektromagnetike
gravitational force	forca gravitacionale
gravity	gravitet
orientim	orientim seksual
sexual	seksual
orientation	orientim
strong	fortë
soft	butë
weak	dobët
Bible	Bibla
circle	qark
complain	qahem
peculiarity	veçanti
fight	luftoj
desirable	dëshirueshëm
sit	ulem
entertain	zbavis
entertaining	zbavitës
lose	humb
lose	humbas
sensation	ndjesi
glove	dorashkë
wild	egër
domestic	shtëpiak
distort	shtrembëroj
distortion	shtrembërim
bestial	kafshëror
animal	kafshë
thievery	hajdutëri
thief	hajdut
bite	kafshoj
bite	kafshatë
sympathy	keqardhje
sympathetic	keqardhës
excellent	shkëlqyer
excel	shkëlqej
excellent	shkëlqyeshëm
immortal	pavdekshëm
primary	parësor
peach	pjeshkë
pear	dardhë
nectarine	nektarinë
mandarin	mandarinë
campaign	fushatë
hold	mbaj
retention	mbajtje
containment	përmbajtje
maintenance	mirëmbajtje
generally	përgjithësisht
general	përgjithshëm
generalization	përgjithësim
generalize	përgjithësoj
fresh	freskët
produce	prodhoj
except	përveç
mammal	gjitar
understandable	kuptueshëm
understanding	kuptim
misunderstand	keqkuptoj
incomprehensible	pakuptueshëm
imply	nënkuptoj
visitor	vizitor
communicate	komunikoj
contradict	kundërthem
inexplicable	pashpjegueshëm
explain	shpjegoj
huge	stërmadh
institution	institucion
energetic	energjik
civilized	qytetëruar
lightweight	lehtë
stay	qëndroj
whole	gjithë
crusade	kryqëzatë
lethargy	letargji
lethargic	letargjik
read	lexoj
legible	lexueshëm
dignity	dinjitet
brotherhood	vëllazëri
spontaneous	vetvetishëm
lie	gënjej
reading	lexim
careful	kujdesshëm
cultural	kulturor
gather	mbledh
solar	diellor
stellar	yjor
oppose	kundërshtoj
toy	lodër
unfriendly	jomiqësor
friendly	miqësor
translator	përkthyes
translator	përkthyese
admirer	admirues
admirer	admiruese
masturbator	masturbues
masturbator	masturbuese
teacher	mësues
danger	rrezik
dangerous	rrezikshëm
vote	votoj
business	biznes
get drunk	dehem
behaviour	sjellje
axe	sopatë
disease	sëmundje
firefly	xixëllonjë
together	bashkë
attach	bashkëngjis
pile up	grumbulloj
fighting	rrahje
I	krahasoj
comparison	krahasim
comparable	krahasueshëm
comparability	krahasueshmëri
comparative	krahasues
moist	lagësht
sweetness	ëmbëlsi
rumor	thashethemëxhi
imagination	imagjinatë
imaginable	imagjinueshëm
fear	frikë
extract	nxjerr
carry	byr
train	stërvis
destroy	shkretëroj
destroy	shkretoj
destroy	shkretnoj
Tosk	damshëm
adverse	dëmshëm
Tosk	gegnishte
Gheg	gegërishte
Gheg	gegizëm
Tosk	toskizëm
Tosk	tosknishte
Tosk	toskërishte
hazel	lajthi
instruct	udhëzoj
instruction	udhëzim
gnaw	brej
foolishness	marri
vagina	vaginë
vagina	vagjinë
blackberry	manaferrë
legendary	legjendar
legend	legjendë
are you allergic to any medications	a jeni alergjik ndaj ndonjë medikamenti
pharmacology	farmakologji
I	mbuloj
Arvanitic	ƅ
define	përkufizoj
miracle	mrekulli
miraculous	mrekullueshëm
limb	cung
hearthstone	caran
bring	qel
sleep	fle
lily	zambak
fuckable	shkërdhyeshëm
socialism	socializëm
improve	mirësoj
pig	thi
beekeeper	bletar
blanket	batanije
barge	drang
Satan	shejtan
soul	shpirt
animate	shpirtëroj
darling	xhan
treat	trajtoj
nauseate	neverit
inhabitant	banor
make	molis
olive	ulli
drip	pikoj
squint	vangoj
put	betoj
offer	blatoj
grek	greke
carve	latoj
live	jetoj
imam	hoxhë
hoe	çap
bulb	poç
try	provoj
thorax	kufar
rush	turrem
leg	këmbë
platinum	platin
fox	dhelpër
Christmas	Kërshëndella
scheltopusik	bullar
feed	koj
August	gusht
cut	vilas
dumb	dudum
lady	zôjë
lambkin	milor
trachea	porrs
scenario	skenar
pair	çift
day	ditor
motivate	motivoj
hate	urroj
congratulate	uroj
hate	urrej
hedgehog	uriq
Gheg	emën
salt	krypë
vegetables	perime
come on	hajde
desk	tavolinë
meadow	livadh
ink	bojë
kitchen	kuzhinë
shoulder	shpatull
spark	shkëndijë
deserted	shkretë
saw	sharrë
saddle	shalë
kidney	rrâni
adoration	adhrim
adoration	avrim
bravo	afërim
side	ânë
pant	dihat
white willow	shelg
blood feud	gjakmarrje
feud	hasmëri
tuft	thak
crime	krim
per capita	për kokë
scapegoat	kokë turku
headache	kokëçarje
pain	dhembje
ligj	ligj i luftës
speech	ligjëratë
legalization	ligjërim
legalize	ligjëroj
lawfully	ligjërisht
lecturer	ligjërues
law-abiding	ligjzbatues
mud	llucë
flirt	flirtoj
interpret	interpretoj
luaj	luaj bixhoz
gamble	bixhoz
bixhoz	letra bixhozi
line	linjë
airline	linjë ajrore
telephone line	linjë telefonike
assembly line	linjë prodhimi
pipeline	linjë furnizimi
hare	lepur
kafaz	kafaz lepujsh
pen	kotec
tool	hallet
personal	vetjak
surprisingly	çuditërisht
carnivorous	mishngrënës
perfect	përkryej
angel	engjëll
fish	verzë
field maple	ulzë
hackberry	vidh
silver birch	mështekër
crag	krep
rocky	karpë
kite	qift
animal	shtazë
pull	heq
hunting	gjah
circle	rreth
bullock	tarok
deep	thellë
deer	dre
wax	dyllë
honeycomb	huall
soften	brydh
twig	bilonjë
green	blertë
right	djathtë
mare	pelë
democratic	demokratik
chilblain	morth
kam	kam një pyetje
try	tentoj
bridle	fre
sell	shes
agreement	dakort
time	kohë
buttfucker	bythëqirë
slut	zuskë
devil	pafe
exhausted	lekur
lizard	hardhucë
sack	thas
her	saj
supervisor	kujdestar
chapel	tempull
December	dhjetor
fry	fërgoj
sausage	kolloface
racial	turkoshak
nationality	kombësi
nationally	kombëtarisht
adverb	-isht
supervise	mbikëqyr
supernatural	mbinatyrshëm
natural	natyrshëm
tasty	shijshëm
loud	zhurmëmadh
sexually	seksualisht
rise	ngrihem
pederastic	pederastik
start	filloj
male	mashkull
like	siç
motion	lëvizje
gain	përfitoj
cell	qelizë
cellular	qelizor
similar	ngjashëm
homosexual	homoseksual
big-headed	kryemadh
chiefly	kryesisht
concentrate	përqëndroj
naked	bythëjashtë
grease	yndyrë
history	histori
historically	historikisht
whoever	kushdo
nuk	nuk e di
effectively	efektivisht
chest	gjoks
spillage	derdhje
wake up	zgjoj
wake up	zgjohem
spherical	rrumbullak
erection	ereksion
ejaculation	ejakulacion
buttocks	mollaqe
lexicology	leksikologji
lazy	dembel
funny	qesharak
cocky	xhagajdur
hell	xhehenem
hell	xhenem
hell	xhehnem
heaven	xhenet
violence	dhunoj
official	zyrtar
unofficial	jozyrtar
officially	zyrtarisht
unofficially	jozyrtarisht
usually	zakonisht
morphology	morfologji
Cham	Çam
look	kërkoj
adverb	ndajfolje
leave	lë
mountainous	malor
transitive	kalimtar
intransitive	jokalimtar
undemocratic	jodemokratik
nonreligious	jofetar
religious	fetar
technology	teknologji
analogy	analogji
zoology	zoologji
anthropology	antropologji
apology	apologji
astrology	astrologji
astrobiology	astrobiologji
biotechnology	bioteknologji
chronology	kronologji
dermatology	dermatologji
ecology	ekologji
geometry	gjeometri
embryology	embriologji
genealogy	gjenealogji
geography	gjeografi
physiology	fiziologji
psychology	psikologji
sociology	sociologji
sexologist	seksolog
sexology	seksologji
sexological	seksologjik
genetics	gjenetikë
genetic	gjenetik
travel	shtegtoj
blindly	verbërisht
annul	shfuqizoj
annulment	shfuqizim
that	që
insular	ishullor
government	qeveritar
warrior	luftëtar
carpenter	zdrukthëtar
scientist	shkencëtar
scientifically	shkencërisht
stop	ndalem
thick	mjegullnajë
fried	fërgesë
roasting	tavë
go crazy	budallallosem
ignorance	injorancë
ignorant	injorant
ignore	injoroj
ignore	injorohem
intelligence	inteligjencë
intelligent	inteligjent
smart	mençur
skillful	shkathët
unbelievable	pabesueshëm
simultaneously	njëkohësisht
shit	përmutem
announce	njoftoj
notice	njoftim
unblocked	zhbllokohet
astrobiologist	astrobiolog
alcohol	alkool
njëjës	numri njëjës
shumës	numri shumës
hole	birë
archer	shigjetar
origin	zanafillë
flow	rrjedhje
our	ynë
your	juaj
misunderstanding	keqkuptim
lidhor	mënyra lidhore
dëftor	mënyra dëftore
kushtor	mënyra kushtore
dëshiror	mënyra dëshirore
habitor	mënyra habitore
urdhëror	mënyra urdhërore
shpejtësi	shpejtësia e dritës
not	së
distant	largët
I'm sorry	më falni
I'm sorry	më fal
escaped	ikur
entrance	hyrje
constellation	yjësi
amount	shumë
të	fërguara
worker	punëtor
work	punë
co-worker	bashkëpunëtor
employment	punësi
employed	punësohem
employ	punësoj
employee	punonjës
employer	punëdhënës
employed	punësuar
të	punësuara
të	adoptuara
të	adaptuara
të	shquara
të	shurdhuara
të	gëzuara
të	ndërlikuara
të	mërzitura
të	dashura
të	zgjuara
të	organizuara
të	admiruara
të	njohura
të	panjohura
të	djersitura
të	përsosura
të	vdekura
të	humbura
të	zhveshura
të	dehura
të	masturbuara
të	shkëlqyera
e	veta e parë
e	veta e dytë
e	veta e tretë
useful	vlefshëm
parabola	parabolë
mathematics	matematikë
mathematically	matematikisht
të	pjekura
third	tretë
second	dytë
bill	faturë
terrifying	llahtarshëm
strategy	strategji
waterfall	ujëvarë
declension	lakim
forbid	ndaloj
mirror	pasqyrë
idealism	idealizëm
disappearance	zhdukje
paradigm	paradigmë
unreasonable	paarsyeshëm
deflower	zhvirgjëroj
deflowered	zhvirgjërohem
deflowerment	zhvirgjërim
virginal	virgjër
city hall	bashki
dredh	dredh bishtin
someone	dikush
somewhere	diku
somehow	diqysh
somehow	disi
how	qysh
monster	përbindësh
singular	flitet
interjection	pasthirrmë
preposition	parafjalë
adjective	mbiemër
evolve	zhvillohem
develop	zhvilloj
evolution	zhvillim
sodomy	sodomi
sodomized	sodomizohem
sodomize	sodomizoj
genocide	gjenocid
geologist	gjeolog
geology	gjeologji
geological	gjeologjik
geologically	gjeologjikisht
chess player	shahist
priapism	priapizëm
gift	dhuratë
what's your name	si quheni
what's your name	si quhesh
world	dynja
powerful	fuqishëm
some	disa
alphabetical	alfabetik
me	meje
diversity	larmi
Gypsy	gabel
tonight	sonte
geometric	gjeometrik
geometrically	gjeometrikisht
time	lasht
Albania	Shqipnia
and	edhe
on	mbi
on top of	përmbi
among	nëpër
inter-	ndër-
between	ndër
between	ndërmjet
put	vë
robust	ardhangët
de-	sh-
de-	zh-
silk	mëndafsh
galaxy	galaktikë
cotton	pambuk
sneeze	tështij
sneeze	teshtij
fart	pjerdh
outside	përjashta
trans-	për-
for	për
out	jashtë
bathe	lahem
important	rëndësishëm
maturity	pjekuni
maturity	pjekuri
moon	hanë
poor	vorfën
travel	udhëtoj
look at	shikoj
systematic	sistematik
systematically	sistematikisht
grow	rritem
logistics	logjistikë
intercourse	marrëdhënie
start	fillim
affirmation	pohim
relax	relaksohem
like	pëlqej
pour out	derdh
touch	prek
meet	njihem
enough	mjaft
experience	përvojë
yours	yti
ours	yni
yours	juaji
his	tiji
nga	nga pak
slowly	dalëngadalë
moan	rënkoj
back	kurriz
pump	pompoj
close	mbyll
find	gjej
caress	ledhatoj
age	moshë
again	përsëri
turn	kthej
turn	kthehem
change	ndryshoj
differ	ndryshohem
poke	ngacmoj
peepee	bibilush
fuck	qirje
strength	fortësi
kiss	puth
respond	përgjigjem
member	anëtar
send	dërgoj
free	çliroj
free	çlirohem
curious	kureshtar
daring	guximshëm
meet	takohem
found	themeloj
independent	pavarur
independently	pavarësisht
independence	pavarësi
indispensable	domosdoshëm
healthy	shëndetshëm
opposite	kundër
ironic	ironik
ironically	ironikisht
extramarital	jashtëmartesor
external	jashtëm
structure	strukturë
unforeseen	paparashikuar
unforeseeable	paparashikueshëm
replaceable	zëvendësueshëm
needle	gjilpërë
reason	shkak
over	sipër
use	përdorim
use	përdor
usable	përdorshëm
zone	zonë
erogenous zone	zonë erogjene
simply	thjeshtazi
simply	thjesht
të	thjeshta
alluring	joshës
prefer	preferoj
prefer	parapëlqej
preferable	preferueshëm
preferred	preferuar
tire	lodhem
olive	zeshkan
beat	palloj
react	reagoj
reaction	reagim
complete	mbaroj
completed	mbarohem
sweep	fshij
message	mesazh
talk	bisedoj
Serbia	Serbi
good evening	mirëmbrëma
announce	shpall
announcement	shpallje
stroke	përkëdhel
function	funksion
beard	mjekërr
blond	bjond
admonish	qortoj
slave	skllav
slavery	skllavëri
enslave	skllavëroj
enslaved	skllavëruar
under	nën
Romania	Rumani
piss	shurroj
piss	shurrohem
urine	ujët e hollë
urine	urinë
center	qendër
health	shëndet
direct	drejtpërdrejt
e	Shtetet e Bashkuara të Amerikës
të	bashkuara
request	kërkesë
hummingbird	kolibër
valley	luginë
vulva	vulvë
urinate	urinoj
urination	urinim
piss	pshurr
manly	burrëror
masculinity	burrëri
attack	sulmoj
attacked	sulmohem
attack	sulmim
victory	fitore
activism	aktivizëm
heterosexual	heteroseksual
bisexual	biseksual
lesbian	lezbike
enigmatic	enigmatik
enigma	enigmë
forgetful	harraq
storm	stuhi
stormy	stuhishëm
sad	trishtohem
linguistically	gjuhësisht
raise	ngre
I	kruaj
lëng	lëng seminal
Muslim	mysliman
upper arm	llërë
conversation	bisedë
welcome	mirë se vjen
welcome	mirësevjen
welcome	mirësevini
welcome	mirë se vini
anus	vrimë e bythës
I	bëhem
nominative case	emërore
case	rasë
dative case	dhanore
genitive case	gjinore
ablative case	rrjedhore
accusative case	kallëzore
indefinite	pashquar
form	trajtë
title	titull
together	së bashku
lead	udhëheq
leadership	udhëheqje
lead	udhëhiqem
pull	tërheq
modern	sotëm
translate	shqipëroj
completely	tërësisht
lodge	buj
dance	kërcej
yesterday	dje
still	akoma
plenty	vud
patronymic	Adami
agonizing	rure
broach	çem
sack	thes
entertain	argëtoj
party	aheng
accept	pranoj
Monday	e hënë
pierce	cuk
divide	daj
kecër	kec
bite	kic
dark	xuk
yeast	tharm
earring	vath
dragon-woman with seven heads	lubi
Scorpio	Akrepi
scale	peshore
Aries	Dashi
Gemini	Binjakët
Sagittarius	Shigjetari
Capricorn	Bricjapi
Aquarius	Ujori
Pisces	Peshqit
arrow	shigjetë
turnip	rrepë
touch	cek
haystack	mullar
small	bisk
jealousy	zili
burn	cuks
penis	luc
lamb	qengj
hogget	rrunë
wrinkle	rrudhë
rainworm	rrime
worm	krimb
head	krye
comb	kreh
garlic	hudhër
vetchling	modhull
rennet	rrëndës
thickly	burdhë
weasel	bukël
peak	thep
button	thumbull
nail	thua
badger	vjedull
sour	thartë
sprout	mugull
moment	mënd
fennel	maraj
werewolf	luqerbull
child	fëmijë
stepson	thjeshtër
maternal grandmother	joshë
paternal grandmother	nulë
stepmother	njerkë
pussy	gop
wasp	grerë
throat	grykë
cheese curd	gjizë
sow	dosë
bird	shpend
holm oak	ilqe
Italian oak	shpardh
oak	dushk
piglet	derrkuc
calf	viç
heifer	shterrë
Arbëresh	gjedhë
stallion	hamshor
bee	mjalcë
cock	gjel
Tosk	toskë
lizard	zhapi
Turkey oak	qarr
animal	këlysh
pine marten	shqarr
mole	urith
squirrel	ketër
nit	thëri
ant	thnegël
fairy	zanë
parent	prind
fear	droe
elf	karkanxholl
clematis	kulpër
ivy	hurdhe
whey	hirrë
penis	loqe
rheum	gloq
tooth	dhëmb
caterpillar	vemje
leech	shushunjë
writing	shkrim
reason	arësye
year	sivjet
year	vjet
benefit	dobi
say	shqipoj
button	sumbull
slander	shpif
insult	ofendoj
weigh	peshoj
weigh	peshohem
weight	peshë
help	ndih
feel	ndihem
question	pyetje
mortar	llaç
anger	duf
stop	ndal
beg	lyp
smart	dhemb
do-	m-
freeze	ngrij
consist	konsistoj
salvage	shpëtim
cat	maç
affinity	afri
I	sakrifikoj
err	gaboj
wither	vyshkem
stay	mbet
touch	cing
be	stopohem
getting	zbehem
make	zbeh
mind	mendje
erase	shuaj
press	shtyp
call	thërras
destroy	prish
burn	djeg
freeze	mardh
earthquake	tërmet
return	urdhër
order	urdhëroj
listen	degjôj
yellow	verdhë
troubles	ndes
destruct	shkatërroj
bind	lidh
let	lëshoj
discharge	shkarkoj
load	ngarkoj
crown	kurorë
trousseau	pajë
net	rrjetë
sage	sherbelë
wing	fletë
mistletoe	veshtull
dust	pluhur
stepfather	vitërk
stepfather	njerk
colostrum	kulloshtër
barren	shterp
value	vlerë
bestow	dhuroj
devil	djall
bear	duroj
justify	justifikoj
direct	drejtë
show	dëftoj
damage	dëm
to	dëshmoj
forge	farkë
fqinjë	fqinj
ash	frashër
short	shkurt
ray	rreze
November	nëntor
October	tetor
September	shtator
July	korrik
June	qershor
cherry	qershi
January	janar
gland	gjendër
blister	fshikëz
invite	ftoj
squeeze	shtrëngoj
costly	shtrenjtë
hindrance	pengesë
paper	kartë
Shtriga	shtrigë
mop	shtupë
look like	shëmbëllej
image	shëmbëlltyrë
sane	shëndoshë
sign	shenjë
sign	shënoj
serve	shërbej
cure	shëroj
moth	tenjë
shingle	tjegull
board	dhogë
terror	tmerr
drill	turjelë
crowd	turmë
clover	tërfil
oat	tërshërë
line	vijë
bile	vrer
will	vullnet
gush	vërshoj
cross	kryq
monitor	vëzhgoj
cut	shkurtoj
exchange	shkëmbej
exchange	këmbej
embers	shpuzë
curse	mallkoj
appreciate	çmoj
glass	qelq
resin	rrëshirë
kidney	veshkë
sparse	rrallë
suffer	pësoj
I	përtoj
tale	përrallë
power	pushtet
thumb	pulqer
thumb	gisht i madh
pulp	pulpë
priest	prift
gate	portë
people	popull
people	njerëz
poplar	plep
wound	plagë
part	pjesë
pergola	pjergull
cantaloupe	pjepër
pinfeather	pupël
regret	pendohem
gout	gutë
gout	podagër
bride	krushk
old	vjetër
Easter	pashkë
gospel	ungjill
church	kishë
Christian	krishterë
spleen	shpretkë
Mass	meshë
sword	pallë
I	pajtoj
I	pagëzoj
knot	nyjë
count	numëroj
comfort	ngushëlloj
narrow	ngushtë
narrow	ngushtoj
confine	ngujoj
miserable	ngratë
dip	ngjyej
feel	ndiej
nature	natyrë
rest	mërzej
drawers	brekë
Wednesday	e mërkurë
Tuesday	e martë
anger	mëri
time	herë
Thursday	e enjte
Friday	e premte
Saturday	e shtunë
Sunday	e dielë
emigrate	mërgoj
sleeve	mëngë
sin	mëkat
must	musht
mosquito	mushkonjë
plague	murtajë
thousand	mijë
niece	mbesë
marry	martohem
praise	lëvdoj
laud	lavdëroj
plough	lëroj
plough	plugoj
ail	lëngoj
swallow	gëlltis
council	këshill
bell	këmbanë
convention	kuvend
fruit	fryt
cup	kupë
peg	kunj
news	kumt
drain	kulloj
collar	kular
hemlock	kukutë
recall	kujtoj
krijova	krijoj
sajova	sajoj
crest	kreshtë
Lent	kreshmë
fast	agjërim
thigh	kofshë
kalorëse	kalorës
cane	kallam
side	ijë
sweet chestnut	gështenjë
herd	grigjë
flock	tufë
rumble	gjëmoj
trial	gjyq
limb	gjymtyrë
exultation	gazmend
shudder	fërgëlloj
storm	furtunë
oven	furrë
godson	famull
spigot	duq
duty	detyrë
rime	brymë
loom	avlëmend
patch	arnoj
crate	arkë
beam	tork
Satanism	satanizmi
honeyberry	carac
know	njoh
adorn	zbukuroj
greenfinch	afçë
chaffinch	avdos
badger	baldosë
asphodel	badër
bitter	hidhur
frost	mardhë
tire	lodh
silver fir	molikë
brome	modhë
vomit	vjell
never	kurrë
butcher's broom	rrushkull
plane tree	rrap
peel	rrjep
wide	gjerë
full	plotë
hail	breshër
starling	shturë
Eurasian blackbird	mëllenjë
hop hornbeam	mëllezë
grudge	mëllë
Turkey oak	mëllak
lamb	shtjerrë
I	shtoj
dry up	shter
other	tjetër
pen	thark
milk	mjel
spot	njollë
moist	njomë
warm	afsh
breath	avë
food	amëz
strawberry	dredhëz
nit	ergjëz
sling	blorë
tearful	losh
run	ngah
drive	ngas
hair	ngatërr
tangle	ngatërroj
push	shtyj
croze	gardhën
bronchial tube	zgerdhë
breast	gji
small	zgjiç
God	perëndi
I	perëndoj
eagle	shqipe
griffon vulture	shkabë
griffon vulture	gabonjë
oidium	hith
nettle	hithër
he-goat	harrok
throw	hedh
terrain	gërgalle
region	krahinë
chest	kraharor
fart	pordhë
thrive	mbij
tail	bisht
pomace	bërsi
Colubridae	bollë
plant louse	gjonth
aphid	gjoc
tick	rriqër
tart	athët
restharrow	athje
icicle	ehull
mash	qull
grandmother	gjyshe
divide up	përdaj
divide	ndaj
stimulate	stimuloj
lamb	shqerrë
burden	barrë
livestock	dhen
high	epër
hood	kaçule
filthy	ndrag
alive	gjallë
to	ngjallë
vine	hardhi
distract	hutoj
cough	kollë
knead	mbruaj
way	udhë
fully	burmë
wellspring	burim
embers	prush
make	fëlliq
brushwood	krandë
tooth	grath
fodder	krënd
shank	kërci
rump	kërbisht
ward	lagje
bull	meksh
rear	rris
stay	rroj
king	regj
watch over	ruoj
blister	lungë
forked	çandër
splinter	ashkë
catapult	hobe
milking	mjelcë
shingle	flugë
wing	flegër
sap-wood	urrë
toast	thek
hang	vjerr
running	vrap
whirlpool	vorbull
pipkin	vorbë
father-in-law	vjehërr
mother-in-law	vjehrrë
sharp	mprehtë
bring	prura
call	quaj
cut	qeth
precipitation	reshje
chasm	plasë
crumble	thërrmoj
revolve	dredh
to	dridh
sprain	ndrydh
massage	ndrys
to	tredh
accent	theks
desire	ëndë
tongs	darë
destroy	djerr
stretch	ndej
make	ndoh
to	nduk
disappear	zhduk
light	ndez
light	dhez
strangle	mbys
I	mbush
be	shtaj
kennel	strohë
to	shtroj
den	shtrofkë
stretch	shtrij
wind up	shtjell
wind up	mbështjell
gather	pështjell
to	shtirem
pierce	shpoj
press	ngjesh
invite	grish
dawn	gdhin
dawn	gdhimë
trim	gdhend
gave	dhashë
flow	rrjedh
I	rras
pull	rrëzoj
base	rrëzë
wake up	qoj
awaken	çoj
approach	qas
mock	qall
lead	qell
post	gështallë
wind up	shtall
wheat	shtalb
reptiles	shtërpij
fold	palë
again	prapë
salty	ngjelmë
miserable	mjerë
structure	shtat
pool	amull
silent	fendë
bone	asht
barren	beronjë
fragile	brishtë
pledge	besë
chicken	bibë
green	blerë
lame	çalë
supper	darkë
lunch	drekë
wedding	darsmë
forking	degë
thawing	dejë
run	ndjek
cereal	drithë
thornbush	drizë
fat	dhjamë
violence	dhunë
blooming	endë
mother	ëmë
acorn	gogël
salt	gjollë
thin	hollë
oblong	holli
ear	kalli
straw	kashtë
rush	kashër
net	lakth
dewlap	lapë
rind	labë
dewlap	lapër
tongue	llapë
hatchet	latë
slip	lerë
floor	lëmë
spoon	lugë
scum	makë
mucus	magë
phlegm	makra
cream	mazë
mother	mëmë
fly	mizë
fog	mjergull
fog	njeg
between	mjet
not	s ̊
whole	tërë
dear	ndjerë
until	mjerth
curse	nëmë
gown	petk
torrent	përrue
pine tree	pishë
pollen	pjalm
clod	popël
bud	pupë
radish	rrapë
bush	shkorre
hornbeam	shkozë
yoke	shilor
urine	shurrë
now	nashti
bile	tëmth
twig	trikë
sprout	trishe
sprout	tresh
hair	thinjë
tool	thadër
claw	këthatër
claw	gërthat
Accipiter nisus	krahathadër
clear	thjellët
clear	këthjellët
hook	këthap
lentil	thjerë
ashy	thjermë
squint	vëngëroj
wound	varrë
fold	vathë
handle	vegë
fire	zjarm
bowel	zorrë
burr	rrodhe
ivy	urth
lose	bjerr
to	blegërin
set	ndërsej
poke	cys
split	çart
footstep	shkelm
discern	dalloj
slice	thelë
bedridden	dergj
ill	djerg
gallivant	endem
swell	ënj
cool	ftoh
yawn	gogësij
angry	ngridhem
shout	gërthas
sip	gjerb
drive	gjuoj
incite	këllas
kindle	kalloj
stitch	shqep
contract	tkurr
bend	kërrus
harvest	korrë
measure	kuar
water	lagë
morass	lëgatë
to	leh
sip	llap
sip	llup
greedy	llups
to	mekërij
to	shkreh
set	ngreh
lift	ngredh
ate	hëngra
bowels	angurrë
to	hangër
warm	ngroh
gird	gjesh
hoarsen	ngjirem
tear	çjerr
hoarsen	qirem
to	pashë
property	pasë
chew	përtyp
bring	pjell
sow	mbjell
cover	plah
fabric	pëlhurë
I	rashë
bring	sjell
sift	shosh
sieve	shoshë
stand	mbështet
frighten	tremb
unwind	zhdërvjell
agile	zvjellët
pick	vjel
wean	zvjerdh
prick	ngul
pull	shkul
Tosk	argull
nit	ergjiz
dawn	agull
complain	ankoj
darnel	egjër
dried	eshkë
period	eshë
great	Ajkuna
shame	cipë
matter	lëndë
untilled	lëndinë
be	ngel
knife	thikë
to	thuk
pop	shpërthej
ashes	shkrumb
impregnate	mbars
blossom	bleron
bud	bulë
whelk	brith
milk	tambël
pond	hurdhë
cranberry	thanë
redhead	pruth
measles	fruth
bran	grundë
hellebore	shpendër
cheese mite	shtrep
column	shtullung
change	ndërroj
slip	shkas
knotty	nyç
tree	nyell
pebble	çakëll
pull	qit
big	thel
to	shtriqem
I	fryj
respiratory	freth
spit	jargë
land	tokë
heron	gatë
place	dhatë
room	dhomë
utter	shpreh
a	shprehje
nation	komb
crumb	dromcë
sage	urtë
die	ngordh
row	radhë
demolish	shemb
missile	predhë
lie	rrenë
swallow	dallëndyshe
move	lëviz
line	vizë
draw	vizatoj
drawing	vizatim
press	shuk
boundary	shkulkë
foam	shkumë
whore	horrë
scoundrel	horr
long	tirk
propeller	fuzë
goddess	Prenda
beehive	qengjë
go	shkoj
past	shkuar
village	fshat
white	balë
bubble	flluskë
bubble	bulëz
I	ushqej
thunders	vetëtin
lightning	vetëtim
lightning	rrufe
light	vrëndë
ring	unazë
stammer	belbëzoj
dad	babë
baby	bebë
dance	vallëzoj
cockroach	bumballë
brawl	sherr
use	përdorë
handcuffs	pranga
certainty	duhet
Arbëresh	vapë
adobe	plithar
trim	shkadhit
to	shperr
to	ngrydhem
flame	flakë
hair	flok
spit	shtizë
spit	shtijë
kind	shtangë
full	dëng
flattery	dëngla
puddle	pellg
plough	parmendë
erase	shlyej
death	mortje
inspire	frymëzoj
shrub	thrumbe
shrub	thrumbishtë
unexpected	thagmë
sowbread	burth
ringworm	qere
sheep	cungë
piece	cungishtë
king post	cungal
tipcat	cingël
foundations	themel
beak	sqep
woodpecker	sqepadruth
carpenter	sqepar
plane	zdrukth
transfer	transferoj
deceive	mashtroj
master	mjeshtër
need	nevojë
too	tepër
exaggerate	teproj
exaggeration	teprim
to	kalb
catarrh	këlbazë
fuss	bujë
dive	kridhem
haystack	plog
showerhead	dush
shout	bërtas
scream	britmë
live	banoj
carry out	zbatoj
swear	betohem
continue	vazhdoj
throw	dëboj
expulsion	dëbim
shout	klith
investigate	hetoj
observe	hulumtoj
chain	hallkë
world	hallk
ditch	hallkomë
happen	ndodh
bilberry	thrashegër
supple	drydhët
tray	aplladhe
resurface	shkridhem
frost	ngricë
melt	shkrij
to	shkrydh
to	shkrif
squeeze	shtrydh
scrawl	shkrabë
tear	gërris
scratch	gërric
scratch	gërvisht
stream	rrymë
wake	rrym
cheek	bulçi
lump	brengë
afflict	brengos
bumblebee	brumbull
morning	mëngjes
evening	mbrëmje
harness	mbreh
hurt	lëndoj
clean	pastër
liver	mëlçi
seed	bërthamë
strength	fuqi
jay	grifshë
scrape	gërryej
erosion	gërryerje
bitter	bresë
bitter	radhiqe
ladybug	burbuqe
I	flijoj
sacrifice	flijim
show	tregoj
merchant	tregtar
trade	tregti
trade	tregtoj
dwelling	banë
dwelling	banesë
strong	bundë
sprout	neth
sprout	syth
glasses	syze
peeled	tallë
delirium	jerm
cold	cermë
break	çars
open	çel
corpse	shtrek
carrion	kërmë
inside	brenda
slaughter	plojë
great	dikë
stack	qipi
common reed	plish
small	lilë
disgust	krupë
spring	krua
cornel	drënjë
soup	gjër
Gheg	gjanë
now	hë
to	ryej
observe	qyr
long	rrypinë
mill	dishtë
poison	vrerë
rocky	rrabe
bark	shkëlbozë
membrane	angërr
late	vonë
thelpinj	thelb
a	thelpi
crook	kërrabë
nick	garbë
sediment	llurbë
wart	lyth
mushroom	kërpudhë
bead	rruazë
band	ndrizë
harrow	shqezë
tear	shqyej
briar	murriz
dark	murrët
brown	murrmë
dusk	muzg
wet	mekët
illness	lëngatë
illness	ligatë
greedy	makut
spindle	bosht
to	zhdëp
long	zdap
pale	blehurë
scratch	gërdhij
I	grij
hurts	kësen
crust	kothere
crust	kërce
I	shqymb
wooden	shtalbër
scum	shtrap
sluggish	flashkët
heap	gamule
deep	grellë
ball	lëmsh
mud	llënjëz
ripens	ndulket
bend	pjerr
homework	rangë
kennel	shtrohë
hardened	shtëng
economist	ekonomist
leftover	mbetje
leftover	mbeturinë
dung	pleh
fertilize	plehëroj
fertilization	plehërim
hear	dëgjoj
conscience	ndërgjegje
answer	gjegje
answer	përgjigje
answer	gjegj
responsibility	përgjegjësi
eavesdrop	përgjoj
hear	gjoj
lure	ndjell
palm	shputë
paw	putër
down	poshtë
big	shkulm
become	vrenjt
bad	vranësi
a	rreng
quick	vring
impetus	vrull
boyar	bujar
wear	mbath
take	zbath
barefoot	zbathur
rib	brinjë
bruise	mbresë
doctor	mjek
keel	kallumë
footprint	gjurmë
pants	pantallona
elder	shtog
forsythia	boshtër
attention	vëmendje
drive	çmend
mad	çmendur
nuthouse	çmendinë
device	shkërdhec
wild	shkërbe
imitate	shkërbej
lukewarm	vakët
mild	vakësirë
bruise	mbres
fit together	puq
sock	putë
sale	shitje
shop	shitore
floor	shesh
plain	rrafsh
make	rrafshoj
savage	lushë
gum	dudë
confuse	dënjë
bewilder	vërtit
Gheg	torrë
stir	trazoj
heard	dorbëria
virtue	dhunti
sleep	dremit
feeling	ndjenjë
cream	ajkë
greed	lakmi
crippled	ulok
slab	rrasë
row	rresht
arrange	rreshtoj
keep	resht
pause	reshtje
house	reshte
house	rraqe
without	dudësh
long	ushtë
spear	heshtë
spear	ushtëtar
military	ushtarak
praise	lavdë
praise	lëvdatë
praise	lavdi
horde	hordhi
late	vonuar
delay	vonoj
joy	gëzim
tickle	giciloj
tickle	gudulis
tickle	kilikos
Gheg	gegë
belly	cullë
hiccup	lemzë
plum	kumbull
pumpkin	kungull
hump	gungë
gush	gurgulloj
throat	gurgull
big	gurgule
fist	grusht
ruins	gërmadhë
harden	nguroj
yell	hungëroj
head	kokërr
honour	nder
honour	nderoj
kedhë	kedh
eelgrass	leshterik
threaten	kërcënoj
erosion	grabë
bran	krunde
bent	kruspull
bed	krevat
sing	cicëroj
wheat	grurë
light	çelur
immerse	zhyt
scream	kujë
nape	zverk
son-in-law	dhëndër
miserable	gjor
babble	kotem
cat	kotele
hook	çengel
winsome	kolmë
thistle	rëkuall
brick	tullë
marten	kunadhe
marten	shqarth
hero	kreshnik
grasshopper	karkalec
upper	krakë
croak	kuak
hernia	kulë
scimitar	kordhë
hill	sukë
reed	kallëm
shine	vizull
shines	vezullon
whistle	fishkëllej
wither	fishk
attack	sulem
vulgar word	lapërdhi
rheum	gëlep
bedraggle	laparos
spoil	llastoj
excessive	llasë
chat	llaf
chat	llafos
talk	lomotit
zombie	lugat
blind	lluke
resemble	ngjaj
pour	lysë
ceases	lërej
womb	mitër
highland	malësi
tribesmen	malësor
I	mëshoj
soot	thirr
man	mërkosh
second	shemër
woman	lehonë
annoy	mërzit
madness	marrëzi
sick	sëmurë
left	majtë
sick	sëmundur
lung	mushkëri
defeat	mundje
strain	mundim
great	moujtun
play	loz
scale	luspë
scale	leskër
rind	lëvore
husk	lëvozhgë
furrow	hulli
scum	lëmashk
swamp	moçal
suffering	vuajtje
rage	mllef
raspberry	mjedër
hoe	gërmih
digging	mihje
full	blozhdë
sow	mjell
snowflake	fjollë
in	fjolla-fjolla
stupid	mlysh
Squalius cephalus	mëlysh
belly	mullë
clasp	mbërthej
pull	zbërthej
hasp	mbërtheckë
clutch	kapërthej
release	shkapërthej
taste	shije
taste	shijoj
quickly	shpejt
quick	shpejtë
bulrush	kallm
am	përshpejtoj
leather	meshin
mildew	mushël
heap	birq
foster mother	mendeshë
heifer	mëzore
bull	mëzak
set	ngërmoj
ward	mitur
deep	fellë
Merry Christmas	gëzuar Krishtlindja
cadaver	kufomë
blue	kaltër
to	ndulkem
bridle	gjem
elder	apë
urinate	përmjerr
big	shotë
Taxus baccata	bërshen
shoot	mitë
donkey	kërr
back	mykë
clapper	rrum
lie	rrej
uncle	ungj
aunt	emtë
ass	kërriç
dew	vesë
dragged	zvarrë
look	vërej
run	vrapoj
wheel	vangë
handle	vjegë
tool	vegël
loom	vegjë
loom	tezgjah
tend	zgjat
tend	zgjas
eyebrow	vetull
maybe	vallë
humidity	vlagë
load	barros
big	vigan
device	vigël
gift	vigjë
yeast	tharb
sour	tharbët
court	gjykatë
region	trevë
stick	shkop
crossbeam	shtalkë
look	dukje
messenger	mbles
betrothal	mblesë
combined	mblesëri
combine	mblesëroj
tar	zift
turtledove	turtull
acute	thermë
pression	trysni
arrive	mbërrij
tell	rrëfej
rasp	gërresë
cuticle	qejzë
awake	gdhij
knot	gdhe
tear	shqerr
mud	qyl
heather	shqopë
suspended	pezull
suspend	pezulloj
vaporize	avulloj
three	dhrim
body	kurm
shatter	copëtoj
limit	kufizoj
reptile	rrëshqanor
land	truall
container	kaush
mistake	gabim
return	urdhën
sick	sëmunë
sand	rânë
genius	gjeni
North America	Amerikë
Germany	Gjermani
France	Francë
Croatia	Kroaci
Skopje	Shkup
Tuzi	Tuz
Podgorica	Podgoricë
i	Mal i Zi
Russian	rusisht
Gheg	gegërisht
Tosk	gegnisht
tray	dhisk
shoelace	rripkë
cistern	hauz
old	rrozg
dry	rrozgë
kind	korridh
climb	ngjitem
stingy	koprac
sober	esëll
rotten	mycë
embers	thëngjill
pimple	byc
pimple	elbth
fireplace	votër
vice	huq
fox	skile
crest	fjuhull
a	bulgë
swim	luoz
adder	shligë
jaw	nofull
nickname	nofkë
white	Bardhyl
currency	Lekë
star	Yllballe
white	Yllbardha
starlight	Ylldrita
light	Drita
alive	Ylljeta
little	Yllëza
albanian	Dritan
Snow White	Borbardha
make	sqaq
light	Drit
us	jonë
Arbërisht	arbërisht
Albanian	Arbi
Albanian	Albana
Albanian	Arbana
donkey	gajdhur
save	shpëtoj
lead	prij
Illyrian	Skerdilaid
pleasant	këndshëm
cow	troke
joke	hokë
joke	tallje
crosswise	kërth
weasel	nuselalë
active	dashuroj
armistice	armëpushim
stairs	shkallë
wheel	rrotë
rinse	shpëlaj
midnight	mesnatë
attach	ngjis
life	roni
put in	shtie
pontoon	argsh
tender	brydhët
rocky	karmë
hunting	zagar
peony	bozhure
field maple	krekë
blackbird	mëllijan
heartache	mullâ
flowerpot	garbe
hollow	zgarbë
lump	gërbë
crab	gërthje
tendon	gilcë
hamstrings	gliqe
joint	kilë
groin	gilzë
peritoneum	gjarkëz
large	qarke
veterinary	gjinjës
bosom	gjinjtë
siskin	rrodhës
Egyptian vulture	mjellbardhë
snow	mjellazë
restharrow	athjez
bittern	gakth
girth	qingël
carnation	karafil
Eurasian magpie	grizhël
jay	grizhlemzë
mock privet	kripç
mock privet	krifshë
mane	krifë
head of hair	krip
crane	kurrillë
stork	shtërg
stork	lejlek
stork	kanushë
lousy	morrac
wasp	grerëz
hornet	grerak
stream	përrueth
Clematis vitalba	kulp
ring	rëngë
coot	bajzë
robust	bakull
bump	ballungë
rubbish	blokër
forked	bligë
residue	bram
tamarisk	brukë
blue	bruz
lump	bullungë
biceps	zogth
whitebeam	zokth
alder buckthorn	zogël
pullet	zogë
caress	gledhë
sorb apple	vadhë
rowan	vadhëz
wild service tree	vadhëviçe
juniper	dëllinjë
service tree	shurbë
well	ubël
heel	thembër
stern	shtreze
board	shtreth
pile	shtregë
lay	shtreb
shepherd's purse	shtrapër
bitter	shtarët
deadly nightshade	shprohë
move	shporr
spur	shpor
shirt	shkurte
shake	shkund
sword	shkallmë
dark	surmë
lump	sukull
be	stepem
cornice	spreth
edge	skaj
build	sarkë
snot	qurra
suffocate	prridh
side	pakë
stretch	ndryqem
fear	merë
sloppy	kërrlë
sip	hurbë
agony	hekë
food	hejë
midge	harrje
mite	harlë
scab	halbë
thin	hajmë
thin	hajthëm
stall	gjethkë
stall	gjetkëz
shell	guall
cave	gravë
water	gosë
deep	gobellë
deep	gobetë
hollow	fyçkë
hollow	fyrbë
Forsythia	fyshtër
biting	fraq
biting	thrak
wrath	druth
belly	dangë
leprosy	gërbulë
cloth	teshë
sneeze	teshem
belongings	tesha
water	tamë
big	tangallë
cut	tarr
gale	rribë
strain	rrek
roast	rreshk
rust	ndryshk
pregnant	mbarsë
mating season	mbarsi
favorably	mbarsisht
impregnation	mbarsje
fertility	mbarsmëri
fertilized	mbarsun
impregnation	mbarsurit
carry	mbart
Pyrus communis	dardhëz
European	dardhukël
pear	dardhishtë
flood	derdhazë
stirk	mëzatore
stirk	mëzat
heifer	mështjerrë
narrow	shtrungë
black pine	vgje
stirk	viçok
stirk	viçoke
woodpigeon	vidë
puppy	gucë
bitch	kuçkë
bud	krëndth
shrub	krândç
thicket	krëndulli
thicket	krëndishtë
woodworm	kërrmi
spontaneously	spontanisht
adder	nepërkë
brook	prroskë
torrent	përrua
bald	tollë
crowd	truç
mood	rrebe
bone	rrasht
rubbish	rrangulla
apron	rrag
arrival	ardhje
came	erdha
origin	prejardhje
future	ardhme
avalanche	rungajë
closely	rugjë
diarrhea	purth
stir	pelq
small	lingë
Spanish broom	gjineshtër
leaf	gjeth
blanket	plaf
heifer	mëshqerrë
ice	avër
sauté	cërij
fail	dështoj
failure	dështim
tear	çarë
leaf	çazë
wither	fyshkem
withering	fishkët
lame	galamsh
accident	gand
whole	gangull
touchstone	gashtë
cook	gatuaj
cook	gatoj
prepare	përgatis
tree	gavër
burst	gëloj
leather	gjalm
riverside	gjazë
until	ngjer
stable	gjije
earwig	kabisht
vulture	karbë
rocky	karsh
rocky	kërshë
dry	karthi
laburnum	karthë
bushel	karroqe
bucket	krroqe
woman	kezë
tear	këpus
tear	këput
sole	këputë
tub	kërbë
mountain pine	klekë
loathe	krup
rock	lëkund
woof	liq
woof	lisë
slate	lismë
foul	llukë
pad	mallth
skin	mesë
meet	ndesh
be	ngalem
sate	ngij
sate	ngop
sate	ngos
darken	ngrys
urge	ngut
annoy	ngush
ankle	noçë
count	njeh
cloth	pecë
layer	petë
top	pingë
perpendicular	pingul
tip	pingël
pore	pirë
frequent	pitër
eyelash	pjekë
to	pjetem
downwards	pjetëposhtë
upside	përpjetë
twisted	pliq
honeycomb stomach	porrc
bosom	prehër
purse	punjashe
mention	qek
fallow	qersë
rear	qyrë
blunt	qytë
dark	rimtë
dark	remtë
fallow	rrege
handle	rrëfanë
dog	samë
food	sillë
up	përsipër
attack	sulm
servant	shkarth
across	shkarthi
tiny	kërthi
step	shkelb
tread	shkel
stair	shkelc
humiliate	shkarzej
crumble	shkërmoq
roof	shklesë
scorpion	shkrap
bird	shkrehezë
plunge	kredh
steal	krydh
thick	kridhë
theft	krydhje
viper	shlligë
press	shorr
precipice	shpat
quick	shpjertë
garden	shpet
invent	shpik
dry up	shteroj
diminish	shtërras
be	shuj
slap	shuplakë
mean	skuth
shield	shqyt
dry	terë
on	tëhu
here	këtu
oblique	tërthortë
such	tillë
bundle	tlandër
piece	tokël
become	trenoj
put	truaj
watch over	ruaj
watch	rojë
earth	trokë
make	trokoj
little	typth
pipe	tytë
fragile	theç
dogberry	thënukël
become	thërpehem
stick	thupër
crumb	thërmoj
beak	thind
lentil	thirqe
thin	thkollët
make	ulmej
firebrand	unzë
group	upri
water	urelë
ear	usht
tart	uthët
leave	vdjerr
hole	verrë
shout	vërras
little	vërri
vineyard	vesht
observe	vështroj
crupper	vithe
steam	vogë
dark	vrugët
dandruff	vrokth
marsh	vurg
small	vuth
cast	ysht
wound	zdramë
swell	zdraj
tree	zgavër
side	zgrip
stomach	zgrof
rectum	zgurdhë
ox	zgjedhë
rust	zgjyrë
boil	ziej
shout	zulë
glory	zulmë
immerse	zhys
destroy	shkallmoj
breakfast	shprishë
Bulgarian	shqa
stuffed	fengem
howl	angullij
cradle	djep
mast	drushtë
bladder-senna	drokth
sail	lundroj
on	egjëll
bow	epem
sling	bahe
dragoness	bushtër
cold	cëmoj
song thrush	cëril
sting	cimb
blackbird	cirlë
girl	cucë
prick	cyth
warm	shkath
stiffen	ngath
get	ngec
hair	mashkë
scratch	shpurdh
cringe	shpurdhem
scratch	shpurrit
entourage	shpurë
large	kudh
anvil	kudhër
escape	arrati
duckling	rikë
piglet	rikëz
weed	rungoj
befuddle	trullos
black	zymtë
moth	zgjerbe
open	zgurdulloj
deep	zgorkë
hole	zgafelle
dirt	zdralë
descend	zbres
martin	zborak
make	zbej
sand	zall
stay	yej
constellation	yllnajë
albanian	Shkurte
tear	zbërkoj
rush	xunkth
spark	xixë
irritate	xëgit
fluff	xbunjë
scar	vurratë
trace	vrragë
argument	rragë
wing	flatër
dandruff	zbokth
hill	bokë
ear	bokël
poem	vjershë
need	vjej
I	vlej
serpent	vitore
standing	vishtat
hard	vrazhdë
cloudy	vranët
wound	vrajë
fill	mbloj
rod	vishkull
flyblow	veth
fruitful	veshël
piece	vepër
clay	vegsh
earring	vëth
grave	vorr
uncastrated	vargër
swath	varrjesht
chain	varesë
crease	vanë
hoofbeat	vickë
hoofbeat	vickël
cross	vëngër
thunder	uturij
big	urtundë
bishop	upeshk
bishop	peshkop
completely	ungji
wild olive	ullastër
wild	ullashtër
shout	ulërij
shout	ulurij
lisping	thuthaq
complaint	thirravajë
bread	thipë
thistle	thërreckë
cold	thëllim
partridge	thëllëzë
Passerina	therokë
plant	therpelë
rye	thekër
dry	thatë
on an empty stomach	thashëm
sing	tuturis
haystack	turrë
gathering	trystë
table	tryezë
bore	tryelë
thyme	trumzë
water	trumbë
turbid	trubull
trout	troftë
straightforwardly	troç
sad	trishtë
make	trishtoj
succeed	trevoj
large	tinë
bundle	tirë
sound	tingulloj
woman	xhingël
earring	tingëlla
castanets	tingëz
tench	tingë
Gheg	timën
cold	tëtym
always	gjithmonë
always	tërmonë
upwards	tërmal
trefoil	tërfojë
have	tërboj
oak	tëbutë
shepherd	tëbanë
frown	terrtohem
winnowing shovel	terplote
slope	teposhtë
sinew	tejzë
father	tatë
resentment	tangë
funnel	taftar
stench	taft
corn	shushallë
waterfall	shurqel
shake	shungulloj
mignonette	shukull
push	shtyr
upright	shtuara
goat	shtrosë
repair	ndreq
sparks	shtiaz
miscarriage	shtiak
flock	shtëllungë
marrow	palcë
shake	shkundulloj
earthquake	shkundëllimë
husk	shkoq
explain	shkoqis
rug	shkorsë
castrate	shkopis
pore	shkojëz
billhook	kmesë
dagger	kamë
shine	shkëlqar
spleen	shkëlbazë
catarrh	gëlbazë
slippery	shkazmë
worsen	ngeq
mock	ngërdhej
I	ngrydh
dense	ngrydhët
sodomite	ngollar
spine	shpinë
often	shpesh
comb	pellë
asparagus	shparg
diaper	shpargër
crumb	drudhe
crumb	grimcë
brushwood	drinjë
rust	dryshk
shake	dynd
fondle	dhel
caress	ledhë
slippery	shqitë
tear	shqis
reed	shqirrë
Albanian	arbër
Albanian	arbën
examine	shqyrtoj
rennet	shqile
scissors	gërshërë
scissors	gërthapë
plait	gërshet
crack	kërcas
bend	gërlas
snore	gërhas
pant	grahmë
stench	duhmë
storm	duhi
card	gërhanë
cave	gërfej
creak	gëras
cut	shkalbësoj
sort	shkartoj
structure	shkardhinë
cross	shkapërcej
cross	kapërcej
temptation	shkandull
dismount	shkalis
stick	thupën
dropsy	spith
woodpecker	spikth
reign	sundoj
larynx	skërfyell
ache	sëmboj
euphorbia	rryell
shave	rruaj
stream	rrua
Bosnian pine	rrobull
line	rrjesht
disorder	rrëmujë
thistle	rrëkuall
thrush	rrebull
path	rrajë
churn	rrafës
air	runë
shrunk	rokominë
syllable	rrokje
helix	rrokëz
round	rokëz
spiral	rrokë
bad	rrokoll
disc	rriskë
stone	rrisgë
dig	rrëmih
dig	rrëmoj
steep	rrëmejtë
tip	majë
tip	malë
roll	rrëkëllej
seethe	këllehem
false	rremë
lefthanded	rrëmaç
rennet	rraskë
sniffle	rrufë
sip	rruf
soft	rrufkë
cartilages	rishte
humid	ritë
envy	resë
desert	repë
torn	repuq
grate	rendoj
avalanche	reshpe
knot	rëfyrë
giant	rekës
horizontally	ratë
kennel	ragal
point	qikël
skein	qerthull
situation	gjendje
finding	gjetje
hobble	qapë
sigh	pshoj
arthritis	priqe
freckle	prënjkë
emaciated	prehaluq
therefore	prandaj
therefore	andaj
nearly	pothuaj
devastation	porropi
precipice	përrëpi
precipice	humnerë
net	pllymëz
heavy	pleng
catapult	plengë
hanging	pjerk
benumb	mpij
swine	pisputh
drop	pikë
dry	pështym
spit	pështyj
sneeze	teshtimë
shot	shtënë
loathsome	pështirë
down	pështjerë
wash	pëshkoj
fling	përvjel
deride	përqell
crumble	përshesh
poke	përpush
flood	përmbys
swing	përkund
bend	përkul
temperate	përkorë
touch	përkas
roast	përcëlloj
contest	përbalcë
face	përball
milch	pëlle
burst	pëlcas
inflammation	pezëm
muscle	pejzë
awl	fëndyell
sting	femc
piece	felë
fiber	eshtë
it	duket
be	druaj
fear	drojë
herd	dorbëri
big	dokërr
demons	djemën
board	dërrasë
steep	dërmë
clean	dëlir
hit	dëkoj
lad	çun
what	çë
cold	cemtë
lad	carrok
scrap	carbë
little	camërdhok
bleat	blegërij
mountain	bjeshkë
good	birko
muddy	bërrakë
piglet	bërkoq
fleece	barukë
scab	dregë
competition	garë
ankle	mzith
urge	nxit
knife	kadhë
sour	hikërr
bud	lumak
lath	trath
armful	kapë
crumb	grimë
mullet	qefull
rubble	lëmaqe
path	kapth
panting	shtegth
mullein	lëpushë
corpse	mërshë
glutton	lupesh
foliage	kreshkë
linden	blishtë
thicket	grehull
snail	kërmill
white	larë
stagnant	makërr
hole	brimë
remain	mbes
lame	kaçel
hairy	kalesh
pleasure	këndë
puddle	kllapë
stand	kërlesh
fill	kërtyl
grin	kërveshem
steep	rëpjetë
downwards	përposh
below	rëposh
clip	shkmes
call	zëj
sigh	fshaj
hit	cerk
thick	trashë
whirlpool	ngjire
curl	krelë
live	amshoj
rudeness	harb
wild	harboj
defilé	lakë
traitor	tradhtar
thirst	eshk
rifle	shklube
protection	ndorje
groove	derpe
groove	derrpe
blond	labardh
thunder	bubullimë
thunders	bubullon
flint	strall
residue	shtradh
base	shtrazë
end	qos
child	kalaman
confuse	kalamend
dysentery	lëbarke
peel	lëvorzë
alms	lëmoshë
field	fushë
soap	finjë
peelings	forbël
breeze	fllad
refresh	flladit
infant	foshnjë
haricot	frashuall
whistle	frushkull
heat	gacë
instill	vjerdh
environment	mjedis
ocean	ujanë
make	ndyj
rudder	lugatë
polyp	likurishtë
spinster	lëneshë
bass	kocë
entrails	shkota
fishing	fuzhnjë
sycamore maple	klenje
common holly	ashe
earth	çapë
inner	ashk
amadou	ashkël
child	ashkth
row	rredhë
row	rradhë
esteem	vyej
precious	vyeshëm
precious	çmuar
color	ngjyros
fine	gjobë
fine	gjobis
pupil	loçkë
mourning	ligje
chickenpox	likardhë
parrot	lorzë
stomach	lukth
debris	lyshtër
oak	imshte
scrap	thelmë
olive	grethac
sand	shtuf
miserable	gjorë
stammering	belbët
bitter	shtarë
false	shtirë
shine	vezull
shake	dyndje
stuff	dend
in	ndë
twitch	përpëlit
flattery	lajkë
loan	borxh
scatter	rroboj
quarrel	zënkë
beyond	përtej
on	këndej
on	këtej
everywhere	gjithandej
stew	gjellë
salt	gjellëz
salt	gjillesë
tickle	kiciloj
paternal uncle	axhë
mould	myk
happy birthday	gëzuar ditëlindjen
birthday	ditëlindje
Gheg	çifteli
apprentice	çirak
radioactivity	radioaktivitet
meeting	takim
quail	drenjë
Albania	Arbëria
the	Arbënia
the	Shqypnia
motorcycle	motoçikletë
teacher	zysh
cucumber	kastravec
manual	doracak
wounding	plagesë
wave	dallgë
squid	kallamar
describe	përshkruaj
black man	zezak
guess	supozoj
crooked	shtremb
hinder	mbodhis
receptacle	pështymore
beat	zbyth
recoil	zbythem
withdrawal	zbythje
nipple	thithë
short	shkurtër
falcon	skifter
trash	bërllog
binman	bërllogxhi
trash	bërdhog
blogger	bëllogxhi
suffer	vuj
bragger	fryfq
bragger	mburracak
proud	mburrem
I	fryhem
people	polem
rice	oriz
ladle	qepshe
sunset	perëndim
coffee	kafeja
newspaper	gazetë
oxygen	oksigjen
desert	shkretëtirë
bucket	kovë
rat	miu i gjirizeve
punch	grushtoj
humiliate	përul
humiliate	përulem
leek	presh
tight	angësht
braggart	angërduf
brag	angërdufem
howls	angullin
feature	tipar
herring	gjuhcë
Turkey	Turqia
dew	versë
sense	shqisë
woodpecker	qukapik
Scops owl	qukë
Eurasian blackbird	qukël
peck	qukem
peck	quk
freckled	qukalosh
hit	çuk
pebble	çukël
part	cukë
leftovers	cukël
tease	thumboj
prison	quzë
childish	fëmijaq
pocket	xhep
subscribe	abonoj
spring	buronjë
spring	burishtë
vineyard	vresht
patience	durim
vineyard	vnesht
flood	dyndallë
protuberance	dallë
nag	gërdallë
side	fajkë
thorn	ferrë
thorn	ferrël
knee-cap	gashtellë
dry	gjeshk
needle	gjëlpërë
needle	gjylpanë
dandruff	hedhe
watershed	hejzë
behold	hinje
marigold	mërgjyzë
fail	mehem
tiny	imtë
oak	imshtë
stale	huptë
old	hutrrojë
up	inj
beetle	kacabu
dust	jezull
stag beetle	kacadre
stag	kacamit
roe	mitëz
climb	kacarroj
stick	ngjit
fish	ngjicë
ankle	yjëzë
shiver	ngjeth
paternal uncle	xhaxha
celebration	festim
Alexander	Aleksandri
constipation	kaps
papaya	papaja
Greece	Greqia
Israel	Izraeli
Norway	Norvegjia
beach	plazh
farm	fermë
difference	dallim
around	rrotull
office	zyrë
evening	mbrëmë
immigration	kurbet
lady	zoj
Albanian	shqyptar
atheist	qafir
weddings	dasma
advance	përparoj
Vietnam	Vietnami
low	sofër
given name	Xhemal
selam	selam alejkum
everything	krejt
watchman	rujtar
watchman	rojtar
abdest	avdes
judge	gjykatës
conversation	muhabet
hurt	plagoj
Jew	çifut
Hebrew	hebraik
Semitic	semitik
anti-Semitic	antisemitik
economic	ekonomik
nationalistic	nacionalistik
Islamic	islamik
psychological	psikologjik
psychologically	psikologjikisht
thematic	tematik
metaphorical	metaforik
geographical	gjeografik
geological	gjeologik
diagnostic	diagnostik
biographical	biografik
autobiographical	autobiografik
congratulation	urim
piece	copë
hurry	nxitim
direction	drejtim
hunter	gjahtar
housewife	amvisë
putrid	qelbës
sheet	çarçaf
mind	hatër
idea	shllim
reward	shkanzë
elucidate	përsiat
agreement	ujdi
peninsula	siujdhesa
boy	voc
horizon	lëpen
orbit	rrokull
pension	ngoje
absorb	ngashnjoj
orgasm	ethol
heart valve	lofk
embryo	ngallec
embryo	endëc
fragment	thyez
wonder	llurdhë
render	amshonj
good luck	trulë
profound	dërti
comfort	fqerënj
lean	kumbi
ocean	kërnalle
ghost	stihji
scare	llavënj
benefit	utull
Clematis vitalba	uvri
poor	vabeh
ravine	pylë
endure	psonj
destiny	psorë
publish	psalënj
plant	prrar
hell	Pisë
rancor	cmirë
dhampir	Kukudh
coagulate	mpiks
mine	përrërë
female	lefe
late	dhespër
fear	dhre
doubt	ehojo
bird song	ëzë
child	bemile
neigh	hingëlloj
get	irënoj
light	izë
harp	jongan
corrupt	halinos
vase	haratull
coin	haromë
down	hjima
cry	hjidhi
paint	shemëllnjënj
produce	ohtënj
wild	onagër
diamond	padamar
clown	ndërdhum
story	pallmadhi
female	pandazëm
ship	papun
decapitate	peleqis
heartbeat	peth-peth
invention	përngjënj
tell apart	përseks
tamed	përtrollëm
miracle	përvist
surprise	çudi
near	pënëz
ox	malloj
morning	nadje
language	nashke
apron	msallë
apron	rrakna
rare	rrasatuk
hot air	vohë
derëzezë	derëzi
hot	hovol
notebook	katërshor
wealth	katimi
day after tomorrow	kosdej
tall	llostua
aulos	longar
narrate	mollois
vehicle	tromopil
flavour	omz
senior	çeltik
thermal	lloxh
laugh	zgërdhihem
pond	zgomëll
withe	purtekë
small	trinë
damaged	shemnoqe
save	kursej
sink	sqoll
absurd	allosua
subtext	kalarupthi
build	ndërtoj
orach	lëpjetë
luck	iballë
head	rradake
confusion	arrkaj
equally	baraz
vine	rruva
fur	gëzof
elder	lalë
pregnant	mprat
paternal aunt	hallë
ore	xeheror
hunting	gjueti
noise	zhurmë
a	hordop
lucky	derëbardhë
curse	mallkim
deign	begenis
call	bëzej
aloft	fjur
chat	gjroj
really	abonsina
regional	arënx
water	adhis
sparkle	rehj
nerve	req
time	qëro
Tosk	pojë
heat	ohtë
January	kallnor
August	djegagur
September	britm
November	brymës
December	dimëror
March	lagëtur
August	dorza
December	djegqerrës
winter	ngrijs
wall	avulli
penis	zhishte
aureola	brerore
radiant	llamburitës
noise	rrapëllimë
see	vagëlloj
delicate	sivonë
discover	diktoj
upside	kala-
turkey	miskë
wrinkle	zhubër
Tomor	Shpirag
church	vakëf
doublet	mëngore
gravestone	muranë
a	Vitorja
giant	Dedalij
giant	katallaj
water	kshetë
toad	shapulicë
tadpole	fulterëz
weapon	shkluhë
cup	llëmbë
knife	frushkë
Judas tree	lofatë
feel	mbërdhi
June	çershinar
the	Zvicra
horse	gjok
flee	mallarr
pot	shtamë
hotbed	mardha
snow	vdor
to	gërmoj
land	gërdhele
cellar	gërdhet
barren	gërdhatë
irritate	gërgas
pick	gërmis
wind	grrykë
readiness	hakrri
Scots pine	hartinë
mortar	harmoç
Tunisia	Tunizia
kind	dheul
I	përdhos
chaff	hjedhë
uncastrated	hokoç
parrot	papagall
bring	harlis
show	kallëzoj
lee	kaptë
swallow	kapërdij
grape	kalavesh
gently	kalecë
corn	karabush
Old Albanian	arbënisht
consonant	-z-
rainworm	karrem
earwig	karrabisht
shout	këlthas
deceive	këndis
to	kënditem
choke	këndirr
pruning	kizë
grunt	kërris
stone	gerrlë
cave	gërrellë
pit	gërrec
place	gërranë
tuft	gërrefshë
hook	gëthep
bran	këshete
teeth	kica
as	kinse
Azerbaijan	Azerbajxhani
explode	këllcas
pointy	bigë
fish	kreshk
vessel	dybek
bundle	bokshe
thick	ushkur
polyp	tetëkëmbësh
bark	cirë
double	dysh
Joseph	Jozef
Mozambique	Mozambiku
transparent	kthjellët
clarify	kthjelloj
clarify	kthjell
caries	briesë
island	ujëdhesë
island	ansujë
now	tashti
birth	lindje
shout	hukas
peanut	kikirik
refrigerator	frigorifer
map	hartë
crossword	fjalëkryq
choice	zgjedhje
roof	çati
chronicle	kronik
Cambodia	Kamboxhia
loudspeaker	altoparlant
Tanzania	Tanzanië
think	pincar
annoy	shqetësoj
Chad	Çadi
Yemen	Jemeni
family	familje
price	çmim
candle	qiri
duty	taksë dogane
tax	taksë
benefit	përfitim
weaver	kaç
hinder	pengoj
hair	qime
sworn virgin	virgjineshë
sworn virgin	burrneshë
island	cekë
mist	lëpe
horizon	lëbozë
waterfall	lëvar
facade	lëvare
become	irnohem
brief	imt
poor	vobekët
pour	gumoj
tragedy	gjëmë
curved	lakesë
meadow	lamth
tornado	legë
inhabitant	lekë
soft	lesjan
nectar	menjë
free	meranë
tombstone	mëkresë
falcon	mirakë
drink	pije
giraffe	gjirafë
thirst	etje
heart	zëmbër
hurry	nxitoj
warm	nxej
trembling	drambur
so	ashtu
so	kështu
conquer	pushtoj
pregnant	shtatzënë
dog	kudër
naked	gollomësh
exult	galdoj
leech	ushunjëz
cry	vigmë
bat	lakuriq nate
touch	mallëngjej
Judas tree	lajthatë
Judas	lafatë
dew	lakshte
robber	landok
ram	latredh
female	lenicë
ivy	lerth
ivy	lerdh
crumble	drudh
hair	drudhë
press	ndryp
peninsula	gadishull
slippers	papuçë
show	shfaq
see	shof
show	shfaqje
thistle	gjembaç
hook	grremç
cloth	leckë
owl	kukuvajkë
hatchling	çuç
midget	xhuxh
approach	afrim
counter	njehsues
bee	bonjë
jobless	bonjar
orphan	bonjak
deplete	zbraz
sunflower	lulediell
trap	grackë
consequence	pasojë
predict	parashikoj
requite	shpërblej
trap	çark
hatred	zët
hush	hesht
do	veproj
toad	thithëlopë
tribe	gjini
house	shpi
characteristic	cilësi
to-	k-
case	çështje
sergeant	rreshter
lieutenant	toger
quantity	sasi
cone	boçe
bottle	bocë
chieftain	prijës
praise	përhiroj
temple	faltore
pharmacy	barnatore
leech	gjakpirës
talk	fjalosem
eyelid	qepallë
age	periudhë
fake	fallco
ceiling	lëpozë
widening	pjetë
workplace	punishte
count	llogaris
everyone	tëtanë
oxcart	qerre
key	kyç
quiver	kukur
semi-human	drangue
doer	bërës
criminal	keqbërës
circle	rrumbull
guess	hamendje
insect	kandërr
midget	mistrec
lilliputian	kacamisër
demon	qipull
manuscript	dorëshkrim
submarine	nëndetëse
noble	fisnik
scarecrow	dordolec
include	përfshij
cowboy	lopçar
bone	kokallë
palm	pëllëmbë
craft	zeje
hello	përshëndetje
kohl	ithmid
mouser	micë
read	zgledh
mirror	shofkë
Daniel	Daniell
Gheg	Berisha
patronymic	Hoxha
offend	fyej
restaurant	gjellëtore
-çme	-çëm
-shëm	-shme
larynx	laring
dimension	përmasë
-çëm	-çme
learn	nxë
weight	lehtësoj
grand-	stër-
notebook	fletore
cucumber	trangull
very	burinë
sunshade	diellore
offer	blatë
hindrance	mbodhi
pagan	besëlashtë
military	ushtrim
call to arms	kushtrim
USSR	BRSS
USSR	Bashkimi i Republikave Sovjetike Socialiste
tall	lartë
greenness	blerim
sausage	kurmagjak
binoculars	tejqyrë
I	mbyt
thakë	thekë
Gheg	Dod
superstition	besëtytni
vitalize	këndell
pliers	pincë
aquarium	akuarium
pillow	kresë
passport	lejekalim
passage	kalim
faint	zalit
heap	berq
black	zezë
light	hirtë
immunology	imunulogji
palm	shpullë
glue	zamkë
tyre	gomë
tariff	tarifë
Gheg	venë
tie	ngërthej
cramp	ngërth
pay	paguaj
Gheg	kepë
tavern	bujtinë
educated	mbruhem
unleavened	mbrumë
unleavened	ndormë
pile	kallume
cattle	gjedh
shank	leqe
polecat	bundër
yes	pjo
ninety	nëntëdhjetë
eighty	tetëdhjetë
seventy	shtatëdhjetë
hedgehog	iriq
place	mriz
brother-in-law	kunat
bribe	ryshfet
molecule	molekulë
quince	ftua
theatre	teatër
brush	furçë
broom	fshesë
Albanian	Skipetar
hexagon	gjashtëkëndësh
course	mësim
-gon	-këndësh
pupil	nxënës
event	vaki
spool	gjep
June	qershori
gel	xhel
Europe	Evropë
head	kryetar
onion	qepa
yellow	lylc
grusht	grusht shteti
synagogue	sinagogë
great	betë
censorship	censurë
walk	heci
milk	tamël
milk	tämël
milk	klumësht
the	klumështi
daughter	bilë
fibula	abetar
put	kullos
Gheg	Ukshin
sheep	bejkë
wool	belcë
judge	gjykoj
close	avit
jackdaw	galë
witch	ganec
më	gërdit
nail	gozhdë
Arbëresh	vobektë
black horse	vraç
grove	zabel
walk	shëtit
request	porosit
sue	padit
cast out	përzë
spread	përhap
divide	përçaj
deride	përqesh
disfigure	përkeq
bush	kaçubë
roe deer	kaproll
herald	kasnec
shake	trondit
disaster	bolbë
thigh	këllk
wedge	pykë
raze	rrënoj
grape	shermend
bring	shëlboj
salt	shëllij
forgive	ndjej
midwife	ndrikull
adapt	mushtëkohem
absent	mungoj
pity	mëshirë
sage	mëgashtër
ferrier	nallban
straight	drejt
leather	shakull
watermelon	shalqi
ugly	shëmtoj
vent	shfrej
zanë	shitoj
asthma	shpirrë
make fun of	shpotit
message	pusullë
rest	pushoj
clear	qartë
govern	qeveris
weeping willow	arqitë
rough	ashpër
spot	lacë
err	lajthit
cabbage	lakër
praise	lavd
windpipe	gabzherr
grove	gajushë
lime	gëlqere
swallow	gëlltit
hole	gërbellë
cave	gërfyell
clarinet	gërnetë
threshold	shqem
sheepskin	gozhup
serpent	grabofç
boils	grafulloj
unripe	gresë
appearing	vegoj
mirage	vegim
precipitate	amti
tasteless	amësht
strong	arushan
finish	kryej
cast out	arratis
Gheg	ujdis
Spanish broom	zhubë
holy water	ajazmë
Scotch	ajdës
black locust	akacie
common	akth
Jerusalem artichoke	allme
turnip	arashkë
wall	arrës
stonecrop	babanik
honest	sinqertë
terebinth	bafër
birdsfoot trefoil	bagolinë
logwood	bakëm
evergreen	balkrocë
sainfoin	ballëbreshtëz
Italian oak	ballgun
Rhamnus alaternus	belot
bilberry	belush
Conium maculatum	beshtë
Jerusalem sage	bezgë
einkorn wheat	bërcel
snowdrop	boçëborë
black pine	borigë
Quercus trojana	bujgër
hoof fungus	bulledër
vetch	buxhak
dog rose	bythëkromë
creeping thistle	carangth
smoke tree	cërmëdell
black pine	çetinë
true laurel	dafinë
mastic	dushkull
wych-elm	hithës
lilac	jargavan
savin	jermësinë
dill	kopër
shovel	kaci
screwdriver	kaçavidë
kashkaval	kaçkavall
kite	kaçubet
breakfast	kafjall
bolt	kajnacë
goat	kakërdhi
child	kalama
guide	kallauz
interest	kamatë
canvas	kanavacë
chest	kanavetë
archivist	arkivist
brimless	kapuç
archivist	arkiviste
draw	kargatis
hut	kasolle
chalice	këlshejt
purr	kerrmëz
double-edged	këllëç
ewer	kënatë
swamp	kënetë
hemp	kërp
goat	kërrutë
castle	kështjellë
delirium	kllapi
ergot	kllogjër
oven	koftor
wooden	korbull
wallet	kuletë
tuberculosis	ndishk
thrifty	nikoqir
trim	krasit
amaze	mahnit
mute	memec
bellwether	ogiç
meadow	ograjë
horseshoe	patkua
sledge	sajë
small	sakicë
hay	sanë
hope	uzdajë
track	vazhdë
smart	veshtë
ore	xehe
manger	grazhd
house sparrow	harabel
goodbye	lamtumirë
round	karavele
ladle	garuzhdë
greater celandine	tamblagjak
earthen	shtambë
marjoram	rigon
rosemary	rozmarinë
celery	selino
spinach	spinaq
celery	sherp
wild thyme	zhumbricë
okra	bamje
fennel	finok
wild thyme	lisën
parsley	majdanoz
peppermint	mendër
peppermint	nenexhik
beetroot	panxhar
right	tagër
wave	tallaz
whim	tekë
meter	metër
millimeter	milimetër
milliliter	mililitër
liter	litër
cumin	qimnon
European	rraboshtë
kilometer	kilometër
millstone	mokër
musical instrument	instrument muzikor
musical	muzikor
guitar	kitarë
am	duhem
edible	hahem
adopted	adoptohem
I	afroj
lost	birrem
concealed	fshihem
placed	vihem
I	shihem
bought	blihem
gnawed	brehem
held	mbahem
known	dihet
I	dukem
promise	premtoj
Pagan	En
knock	trokitje
applause	duartrokitje
applaud	duartrokas
Vancouver	Vankuveri
British Columbia	Kolumbia Britanike
Quebec	Kebeku
normality	normalitet
normalization	normalizatim
Canadian	kanadez
round of applause	raund duartrokitjesh
chirp	ciu-ciu
mirë u pafshim	mirupafshim
bless you	shëndet paç
damnit	dreqin
Pinocchio	Pinoku
open sesame	hapu sezam
Benedicta	Benedeta
home sweet home	shtëpi, e bukur shtëpi
Mickey Mouse	Miushi Miki
cylinder	cilindër
natural	natyrale
magic	magji
event	ngjarje
California	Kaliforni
New York	Nju Jork
interrupt	ndërprej
firework	fishekzjarr
e	Gëzuar Vitin e Ri
drum	daulle
doll	kukull
Japonia	Japoni
association football	futboll
Canadian football	futboll kanadez
Korçar	Korçë
if	në qoftë se
Indonezia	Indonezi
fair	panair
see you later	shihemi më vonë
bladder	fshikë
though	edhe pse
maybe	mbase
prayer	lutje
leave	largoj
Yugoslavia	Jugosllavia
this	kjo
North America	Amerika e Veriut
viewer	shikues
well done	të lumtë
please	të lutem
good night	natën e mirë
nonprofit	jofitimprurës
alas	të raftë pika
Christmas	Krishtlindja
one thousand	njëmijë
see you tomorrow	shihemi nesër
one by one	një nga një
Africa	Afrikë
why	pse
shh	shët
I love you	të dua shumë
one for all, all for one	një për të gjithë, të gjithë për një
strawberry	luleshtrydhe
balloon	tullumbace
good morning	mirëmëngjes
so long	gjithë të mirat
Merry Christmas and a Happy New Year	Përshumvjet Krishtlindjet dhe Vitin e Ri
agreed	dakord
good day	mirëdita
Wales	Uellsi
complaint	ankesë
long live	rroftë
chocolate	çokollatë
bon appetit	ju bëftë mirë
Toronto	Torontoja
imagine	imagjinoj
goal	qëllim
advertisement	reklamë
organization	organizatë
television	televizion
great job	punë e paqme
congratulations	urime
approached	afruar
abstract	abstragoj
approve	afrimohem
Trinidad and Tobago	Trinidad dhe Tobago
Hippocrates	Hipokrati
convinced	bindur
European Union	Bashkimi Evropian
biscuit	biskotë
baklava	bakllava
Great Britain	Britania e Madhe
approve	afirmohem
air conditioner	kondicioner
fight	ndeshje
prohibition	ndalim
Old Albanian	αρbε̰ρίσ̈τ
Albanian	αρbε̰ρ
Arbëreshë	Arbëreshë
opera	operë
orchestra	orkestër
anyway	nejse
and/or	dhe/ose
nickname	paracukël
dungaree	kominoshe
bayonet	kacaturr
bayonet	kacaturrë
cheer	brohoritje
weasel	nusebukur
squeal	cingëroj
bagpipes	cingonë
turkey	qukan
suffix	-oj
umbrella	hijëz
lumberjack	druvar
abyss	skëterrë
fennel	maraq
Gheg	grûnë
Cham	bâj
active	bôna
secondary school	ruzhdije
make	zhurmoj
Tosk	bënj
suffix	-hem
demonstrative	dëftor
shown	dëftohem
reduced	shkurtohem
albanian	Shkurt
dawn	afërditë
dawn	Afërditë
dawn	Afërdit
the	Afërditi
approach	Afrim
the	Afrimi
approach	Afrime
the	Afrimja
white	Bardhyll
unapproached	paafruar
longtime	afatgjatë
short time	afatshkurtër
about	afërisht
approximately	përafrisht
approximately	përafërsisht
approximation	përafrim
vocative case	thirrore
approaching	afrohet
approaches	afron
approximate	përafroj
approximation	përafërsi
Gheg	dhënë
Albanian	dhanë
related	afërt
kind	farefis
connection	lidhje
approximation	përafri
approximate	përafërt
connecting	lidhore
connected	lidhor
suffix	-hna
dedicated	kushtor
wishing	dëshirore
surprise	habitore
returning	urdhërore
on	mby
on top of	përmby
on top of	përmy
answered	urdhëruar
day	Dit
birthday	Lindit
birthday	Linditë
birthday	Lindita
birthday	Linditi
light	Dritë
enlighted	Driton
bosom	prëhën
bosom	prehën
bosom	prëhër
after	mbasi
mediopassive voice	përafrohem
abused	abuzohem
addressed	adresohem
worsen	acarohem
be	adaptohem
admired	admirohem
love	dashni
mediopassive	dashurohem
mediopassive	shqipohem
mediopassive	shqipohet
active	shqipon
active voice	bashkoj
mediopassive	bashkohem
union	bashkim
Albanian	shqiptare
Albanian	shqyptare
Albanian	šḱĭp
Albanian	šḱip
dialect	Çamërisht
tribesmen	kaçërotë
whole	tanë
completely	krejtësisht
fully	plotësisht
adverb	-sht
southern	Labëria
southern	Labëri
epistemology	epistemologji
thing	senë
ashtray	abakë
ritual	avdeshanë
leech	abdhellë
frieze	abë
Abyssinian	abisinas
Abyssinia	Abisini
Morocco	Maroku
ashtray	taketuke
të	proletarë të të gjitha vendeve, bashkohuni
inherited	bashtinë
duel	bejleg
noise	buças
seize	grabit
scatter	hallakat
fast	agjëroj
desire	dëshiror
returned	urdhëror
anointing	bagëm
waterfall	balladër
boat	barkë
suspicion	dyshim
little	picërr
small	qerth
snowman	dardalec
sleet	sqotë
decrease	zvogëloj
Gheg	ungjetë
support	mbështetje
warn	paralajmëroj
ride	kalëroj
cause	shkaktoj
exchange	këmbim
exchange	shkëmbim
attempt	tentim
harness	shfrytëzoj
imagine	përfytyroj
hand in	dorëzoj
besprinkle	priskoj
chief	pringj
guard	proj
defense	projë
nail	prokë
archaic	prozhëm
small	proshëm
archaic	prozhmoj
slander	proshmoj
upland	pllajë
shelf	lëpizë
tar	serë
high	serrë
sphere	rruzull
adornment	sqimë
rumen	plëndës
echo	jehoj
echo	jehonë
heat	zushë
fallow	zmojle
betray	tradhtoj
arsenic	rëzëgojë
best	shëngjetë
swear	përgjëroj
heat	zheg
shoes	opingë
promise	premtim
bloom	lulëzoj
implement	jetësoj
destruction	rrënim
lining	rreshtim
rubble	rrënojë
basketmaker	xunkthëtar
I	barazoj
club	kopaçe
surface	sipërinë
surface	syprinë
surface	sipërfaqe
liberation	shëlbim
although	megjithëse
although	ndonëse
however	megjithatë
offering	blatim
coronavirus	koronavirus
firefly	vezullonjë
sheep	delme
I	turpëroj
invent	trilloj
murmur	nytëroj
thank	kutëndoj
growl	hungërim
seceed	shkëputem
indemnify	dëmshpërblej
put	kundërvë
trade union	sindikatë
protest	protestë
smoothen	lëmoj
carving	gdhendje
hight	lartësi
enormity	stërmadhësi
each	çdo
bank	bankë
while	ndërsa
antiquity	lashtësi
blindness	verbëri
undo	labërgoj
reduce	labërkoj
at	mbë
salty	ngjelmët
mean	poshtër
building	ndërtesë
can	kanaçe
cancer	kancer
capital	kryeqytet
take care of	kujdesem
challenge	sfidë
challenge	sfidoj
chance	shans
possibility	mundësi
diaspora	mërgatë
load	ngarkesë
to	mbrodh
citizen	qytetar
clearly	qartësisht
clarity	qartësi
cover	mbulesë
defence	mbrojtje
description	përshkrim
peanut	kikirrikë
schwa	Anitë
experience	përjetoj
explanation	shpjegim
explicable	shpjegueshëm
I	plotësoj
customs	doganë
the	gega
braid	bishtalec
braid	bisht pëllumbi
dove	pëllumbeshë
the	pëllumbesha
the	grimca
reduce	grimcoj
schwa	Teutë
reduced	grimcuar
lizard	hardhje
small	karuc
growth	rritje
guess	supozim
guess	hamendësoj
patronymic	Gjokë
Albanian	Gjokaj
hit	goditje
lizard	hardhël
motherfucker	nënëqirë
fucked	qirë
Arvanitic	Ε̱
Arvanitic	Ρ̇
Arvanitic	ε̱
Arvanitic	ρ̇
Arvanitic	Ν̇
Arvanitic	ν̇
Arbërisht	αρbε̰ρισ̈τ
bruise	mavijos
bruise	mavijosje
kind	sjellshëm
Arvanitic	γj
Arvanitic	Γj
laugh	qeshje
leader	udhëheqës
Lord's Prayer	Ati ynë
Arvanitic	τσ
Arvanitic	ΤΣ
Arvanitic	τσ̈
Arvanitic	ΤΣ̈
Arvanitic	dσ
Arvanitic	DΣ
Arvanitic	σ̈
Arvanitic	Σ̈
Arvanitic	dσ̈
Arvanitic	DΣ̈
Arvanitic	κ̇
Arvanitic	Κ̇
Arvanitic	ζ̇
Arvanitic	Ζ̇
Arvanitic	χ̇
Arvanitic	Χ̇
Arvanitic	λ̇
Arvanitic	Λ̇
Arvanitic	λλ
Arvanitic	ΛΛ
loss	humbje
marriage	martesë
pillow	jastëk
tongue	gljuhë
Cyprus	Qipro
fish	peshkoj
memory	kujtim
method	metodë
artichoke	angjinare
e	Dhjata e Re
testament	dhjatë
Albania	Arbëri
Albania	Arbëni
note	shënim
offer	ofroj
offer	ofertë
oil	naftë
Koby	Qup
know	njof
Tajikistan	Taxhikistan
own	zotëroj
own	zotnoj
ability	zotësi
celebration	festë
celebrate	festohem
pattern	yrnek
wage	pagë
calmness	qetësi
the	Jakupi
Koby	Qupi
transnational	tejkombëtar
Koby	Çupi
Koby	Çup
Gheg	Dodë
Gheg	Dedë
patronym	Dodaj
descendant	Dedaj
performance	performancë
shepherd	shtëpâ
Gheg	Ded
optative	qifsha nënën
may	qifsha
pruned	kirë
running	vrapim
thanks	pajt
clean	paq
the	paqja
I	pasuroj
I	pastrohem
I	pasurohem
I	shtohem
I	mbushem
I	mbulohem
active	bëra
I	bâhna
I	barazohem
I	krahasohem
side	krahas
Switzerland	Zvicër
dot	pikël
person	pikëlëkurë
I	lakuriqësoj
I	lakuriqësohem
the	Zvicrra
Switzerland	Zvicërr
upper	epërm
low	ulët
honoured	nderohem
I	përkulem
I	turpërohem
I	mbytem
I	shprehem
raise	lartësoj
range	gamë
value	vlerësoj
I	fitoj
I	fluturoj
I	luloj
brooch	lulëse
bunch	lulesë
I	shqim
I	flijohem
I	sakrifikohem
inheritance	trashëgim
I	trashëgoj
glance	shikim
I	hijeshoj
I	përdhunoj
abuse	përdhunë
underfoot	përdhe
filter	filtër
Albanophobe	shipuc
black poplar	shpel
wolf	ulkonjë
thank	haristís
teacher	dhaskal
teacher	gjitonia
to please	parkalés
money	ghranët
square	qaca
toilet	rritrenjët
photograph	rritëratë
make a mistake	zgarrar
saffron	krrokull
one hundred	njëqind
wife	E Bukura e Dheut
goddess	E bukura e Detit
goddess	E Bukura e Qiellit
Supreme	Zojz
war	amahj
so-called	ashtuquajtur
vjedhëse	vjedhës
vjedhës	vjedhëse
palo-rroba	palo-
freeze	narth
agriculture	bujqësi
fire iron	cimbidh
sock	kallcë
best man	vëllam
slow	ngadalë
slow	ngaldaltë
am	ndalohem
comes	dilet
exit	dalje
halt	ndalje
outgoing	dalë
thin	holloj
am	hollohem
thin	tëholloj
am	tëhollohem
process	tymos
pistachio	fistik
Lushnjë	Golem
altar	ilter
descendant	Markaj
descendant	Martinaj
patronymic	Marku
patronymic	Marki
ABC	abëcë
locative case	vendore
genitive	gjenitiv
diathesis	diatezë
active	diatezë veprore
active	veprore
pigeon	gugash
passive	diatezë pësore
reflexive	diatezë vetvetore
cuckoo	qyqe
caterpillar	dhemje
passive	pësor
passive	pësore
active	vepror
reflexive	vetvetor
pronouncing	shqiptim
pronounce	shqiptoj
explanation	shqipëllim
explain	shqipëlloj
scorpion	sfurk
convert	laraman
drawer	syzë
refine	imtësoj
refine	imtoj
distinguish	shquaj
distinguishes	shquhet
distinguish	shquhem
poison hemlock	magunë
plant	makth i egër
mill	thyese
peacock	pallua
treasure	thesar
I	kungoj
virtue	virtyt
marjoram	manxuranë
helmet	tarogzë
deaf	shurdhër
I	shuguroj
shepherdess	bareshë
run	ngaj
thornbush	ferrëlagëse
sour cherry	vishnjë
executioner	therës
archangel	kryengjëll
Virgin Mary	Hyjlindëses
thank you	rrofsh
roe deer	sorkadh
roe deer	sorkadhe
Kosovo	Besiana
dandelion	luleradhiqe
peony	lulegjake
forget-me-not	lule mosmëharro
daisy	luleshqerrë
daisy	lule delme
Cinderella	E Përhitura
to	gjëmtoj
folk	gjinde
to	rëmoj
Gheg	rëmër
Gheg	rrëshinë
Gheg	rëshinë
windpipe	gërlac
to	gulçoj
to	gultoj
worry	gulm
beestings	grëmëratë
gërqinjë	gërk
gërk	gërqinjë
letter	germë
writing	gramë
bent	gërmuq
to	ngjëroj
to	ndëshkoj
Buffalo	kotorr
lamp	luqerë
sheep	lukër
tuberculosis	tërpi
to	ungroj
heap	magulë
child	pjellë
weft	timër
demoness	stihi
through-	mbë-
Tosk	errësirë
dog	shakë
application	letër motivimi
motivation	motivim
motivate	motivohem
of-	skë-
at-	lë-
am	argëtohem
am	kënaqem
remove	shqit
remove	shqitem
goes	qitet
pike	qysqi
jackdaw	stërqokë
mountain	qye mali
cat	macë
cat	mackë
cat	maçok
male	maqorr
bubble	lylë
favourably	mbarë
parachute	parashutë
platypus	sqepor
dress	fustan
faleminderit	faleminderit shumë
German	gjerman
german	gjermane
german	gjermanisht
German	gjermanishte
passport	pasaportë
harp	harpë
whip	kamxhik
society	shoqëri
adventure	aventurë
jacket	xhaketë
defile	ndot
poison	helmoj
am	alarmohem
alarming	alarmim
disappoint	zhgënjej
christian	Jozë
muslim	Jusuf
patronymic	Ademi
patronymic	Zefi
patronymic	Joza
patronymic	Jusufi
patronymic	Jusufaj
patronymic	Zefaj
muslim	Isuf
patronymic	Isufi
patronymic	Isufaj
christian	Joz
nominative	Gjo
Daniel	Danjell
Saul	Palush
patronymic	Palushi
patronymic	Gjergji
patronymic	Gjergjaj
patronymic	Palushaj
patronymic	Palaj
patronymic	Gjonaj
patronymic	Gjoni
patronymic	Hoxhaj
windbreaker	vindjak
windbreaker	vinjak
Jacob	Zhak
Jacob	Xhak
am	qihem
thought	mendim
am	merrem
take	marrtë
vertigo	marramendth
dizzily	marramendthi
madly	marrëzisht
age	plakem
Tosk	lësho
let	lëshohem
back then	lashti
am	lihem
tomato	mollatartë
cupboard	gradencë
self-determination	vetëvendosje
placement	vendosje
stove	shporet
stove	stufë
potato	kërtollë
bast	barmë
cram	mbrus
wood	droshë
lock	ndryj
pond	gandall
Arctic Ocean	Oqeani Arktik
mouth	gurrë
turbine	turbinë
arable	lëngë
breath	ahë
sample	mostër
stuffed	fëngem
-ment	-më
baked	fyshtë
oriental plane	çinar
gritty	gërdham
defect	gërdhitë
chaff	gërdhomë
scratch	gërdhuc
leftovers	gërdheshtër
leftovers	gërdhushtë
murderer	vrasës
nun	murgeshë
mallow	mëllagë
smith	mbathtar
smith	farkëtar
Gheg	hjek
weed	tëharr
conquerer	pushtues
lace	lidhës
flood	përmbytje
Tirana	Farkë
rebel	rebelohem
difficult	zorshëm
egg	vezë
cavity	këthellë
depth	thellësi
deepen	thelloj
house	përbuj
sting	therrë
bald	tullac
sister-in-law	kunatë
scale	mëllugë
midday	mesditë
middle	mjez
midday	mjezditë
midnight	mjeznatë
hesitate	ngurroj
knock	ngjok
enlighten	ndriçoj
rain	rigë
shell	zhguall
diamond	adham
spy	përgjues
citizen	shtetas
gjuhëtare	gjuhëtar
gjuhëtar	gjuhëtare
grekomane	grekoman
wheel	rrath
clown	gaztor
pelican	laradash
magpie	laraskë
insides	brëndës
chest	sënduk
spice	erëz
overcome	ngadhënjej
railroad	hekurudhë
poetry	poezi
blackberry	ferrëmanzë
bear cub	arith
peel	rjep
goodness	mbarësi
mercy	ndjesë
defender	mbrojtës
flower	lulishte
beech	ahishte
Christ	Krisht
steal	trushkyej
besmirch	zhyej
I	mërej
penetrate	depërtoj
