this	ए
lotus	कमल
cloud	मेघ
this	यह
not	नहीं
who	को
thief	चोर
ghee	घी
do not	जनि
Hari	हरि
emphatic particle	ही
father	जनक
gold	कनक
parrot	कीर
season	रितु
country	देस
what	कहा
peregrine falcon	बहरी
grasp	गहन
meet	मिलन
hope	आस
compassion	कृपा
of	कौ
black	कारौ
whoever	जु
to	ताई
for	के कारन
on	पै
whoever	जौन
glass	कांच
rain	बरखा
foot	पाई
cloud	बादर
four	चारि
and	अरु
friend	मीत
quality	गुन
milk	गोरस
good	आछौ
wind	वाइ
hungry	भूखौ
in	माहिं
labour	स्रम
finger	अँगुरी
also	हू
say	कहन
see	देखन
word	बचन
laugh	हंसन
say	बोलन
pleasure	रमन
heart	हिय
word	बैन
cry	रोवन
lover	कंत
pain	सूल
think	सोचन
play	खेलन
foot	चरन
praise	बंदन
king	राइ
cross	लंघन
any	कछु
see	दरसन
deaf	बहिरौ
this much	इतनौ
grain	कन
fault	औगुन
someone	कोऊ
statue	मूरत
split	भेव
from	तैं
why	कत
second	दूजौ
to	सौं
trade	बनिज
deep	गहिरौ
describe	बरनन
your	तुम्हारौ
flute	बाँसुरी
straight	सीधौ
jackal	स्यार
eagerness	उछाह
head	सीस
poison	बिष
venomousness	बिषभाव
violence	हठ
one	-वारौ
home	गेह
jewel	रतन
excitement	हुलास
excitement	उल्हास
female friend	आली
rain	पावस
lightning	बिजुरी
ergative case	नैं
