thumb	палец
Cyrillic	з
Cyrillic	щ
Bulgarian	ъ
Cyrillic	ь
Cyrillic	Я
flour	брашно
pronunciation	произношение
vodka	водка
tsarina	царица
fox	лисица
Po	По
garlic	чесън
чесно́в лу́к	чеснов лук
onions	лук
lover	любовник
almost	почти
as	как
bird	птица
pogrom	погром
residential building	дом
work	работа
lime	липа
web	нет
shit	сера
Tuesday	вторник
look	поглеждам
eye	око
tea	чай
hour	час
glory	слава
home	дома
bald	лис
price	цена
owl	сова
Christ	Христос
mister	господин
forest	лес
formless	безформен
forest dweller	лесник
there	там
Jupiter	Юпитер
in	из
anarchy	анархия
paternal uncle	чичо
maternal uncle	вуйчо
grandmother	баба
March	март
August	август
potassium	калий
middle	среда
minute	минута
cow	крава
tundra	тундра
rhinoceros	носорог
murmur	ропот
book	книга
peace	мир
your	ваш
one's	свой
he-goat	козел
three	три
cur	пес
thick fume	чад
ceramics	керамика
sign	знак
czar	цар
Бо́сна и Херцего́вина	Босна и Херцеговина
n't	не
hazelnut	лешник
Europa	Европа
homosexual	хомосексуален
male homosexual	хомосексуалист
gay	гей
water	вода
cloud	облак
dictionary	речник
ray	зрак
whale	кит
April	април
kin	рода
Russian	руски
brother	брат
however	но
Bulgarian	Щ
Cyrillic	Ю
megatsunami	мегацунами
tsunami	цунами
change	меня
Lord	Господ
word	слово
Venus	Венера
Neptune	Нептун
Uranus	Уран
Saturn	Сатурн
Mars	Марс
uranium	уран
Mercury	Меркурий
moon	луна
Moon	Луна
planet	планета
surname	презиме
name	име
asteroid	астероид
speech	говор
giraffe	жирафа
frog	жаба
Sunday	неделя
alphabet	азбука
Bible	библия
North America	Америка
prayer	молитва
request	молба
zebra	зебра
giraffe	жираф
Balkan mountains	Балкан
square	квадрат
star	звезда
seastar	морска звезда
palm	длан
black	черен
sea	морски
temple	храм
mercury	меркурий
god	бог
foot	нога
Allah	Аллах
four	четири
people	народ
five	пет
six	шест
nine	девет
ten	десет
feather	перо
chair	стол
hundred	сто
soldier	солдат
North Korea	Корея
ocean	океан
or	или
old	стар
reflexive pronoun	се
sheep	овца
school	школа
faculty	факултет
arrow	стрела
army	армия
father	отец
university	университет
Cyrillic alphabet	кирилица
valley	долина
letter	писмо
Latin	латински
lampshade	абажур
male student	абитуриент
absurdity	абсурд
advance	аванс
adventure	авантюра
airman	авиатор
aviation	авиация
bus	автобус
autonomy	автономия
male author	автор
authority	авторитет
male administrator	администратор
address	адрес
analysis	анализ
chemist	аптека
bee	пчела
balcony	балкон
bank	банка
misfortune	беда
calamity	бедствие
biography	биография
bride	булка
storm	буря
century	век
bicycle	велосипед
evening	вечер
wine	вино
war	война
cue	щека
dragon	дракон
ghost	призрак
ceiling	таван
shark	акула
pineapple	ананас
angel	ангел
banana	банан
tribe	род
female	женски
number	номер
helicopter	вертолет
exhibition	изложба
Danube	Дунав
branch	клон
alone	сам
hitchhiking	автостоп
bridge	мост
near	до
away from	от
cathedral	катедрала
tar	катран
juice	сок
raspberry	малина
United Kingdom	Великобритания
city	градски
old city	варош
mama	мама
mother	матер
club	клуб
swastika	свастика
Christmas	Коледа
island	остров
federation	федерация
Englishman	англичанин
Englishwoman	англичанка
Milano	Милано
meat	месо
door	врата
без	със
south	юг
new	нов
cut	сека
tooth	зъб
speak	говоря
ear	ухо
bay	залив
good	добър
green	зелен
white	бял
calendar	календар
only	само
load	зареждам
invalid	инвалид
without	без
winter	зима
oxygen	кислород
culture	култура
Macedonian	македонски
verb	глагол
chestnut	кестен
north	север
hawk	ястреб
west	запад
beer	пиво
Glagolitic alphabet	глаголица
nose	нос
knife	нож
emu	ему
shit	говно
recently	скоро
fear	страх
kingdom	царство
dolphin	делфин
torch	ватра
skin	кожа
almond tree	бадем
Veliko Tarnovo	Цариград
vase	ваза
rabbit	заек
icon	икона
bear	мечка
mole	къртица
gold	злато
horse	кон
otter	видра
donkey	магаре
anecdote	анекдот
hedgehog	таралеж
cat	котка
wolf	вълк
guinea pig	морско свинче
camel	камила
child	дете
mammoth	мамут
wall	зид
bone	кост
graphology	графология
duck	патка
colour	цвят
autobiographically	автобиографично
life	живот
glass	чаша
looking glass	огледало
food	храна
mound	могила
sailor	моряк
wheat	пшеница
homeland	родина
kerchief	марама
comet	комета
television set	телевизор
later	после
stone	камен
library	библиотека
district	област
Monday	понеделник
Wednesday	сряда
Thursday	четвъртък
Friday	петък
Saturday	събота
ghost	дух
DNA	ДНК
baker	пекар
male mason	зидар
community	общество
bee eater	пчелояд
RNA	РНК
monastery	манастир
mind	ум
system	система
dick	хуй
ford	брод
spark	искра
dog	куче
opinion	мнение
silver	сребро
genius	гений
theme	тема
gift	дар
already	вече
male doctor	доктор
lava	лава
sword	меч
market	пазар
olive	маслина
safe	каса
adverbial participle	деепричастие
harem	харем
hell	ад
penguin	пингвин
artiste	артист
architecture	архитектура
baggage	багаж
halva	халва
coot	лиска
leaf	лист
Western Sahara	Западна Сахара
cannonshot	ядро
Farsi	фарси
side	страна
letter	буква
swede	брюква
hurricane	ураган
row	ред
cliché	клише
Serbian	сръбски
night-pot	цукало
sound	звук
voice	глас
fish	риба
image	образ
alligator	алигатор
sex	секс
riffraff	измет
corridor	коридор
telephone	телефон
kitchen	кухня
figure	фигура
but	ала
hydrogen	водород
nitrogen	азот
lead	олово
lithium	литий
platinum	платина
oath	клетва
eagle	орел
Spanish	испански
argon	аргон
chlorine	хлор
phosphorus	фосфор
neon	неон
sodium	натрий
Bulgarian	българин
ice cream	сладолед
peacock	паун
pheasant	фазан
euro	евро
baklava	баклава
Ares	Арес
Nix	Никта
male barbarian	варварин
barbaric	варварски
screen	екран
hand	ръка
choir	хор
mountain	планина
wood	гора
waterfall	водопад
plant	сад
brand	марка
dollar	долар
question	ли
rough	груб
fool	глупак
dupe	будала
small barrel	буре
chalk	креда
cotton	памук
threshold	праг
ice	лед
photography	фотография
politics	политика
rooster	кур
whore	курва
case	падеж
Turkish	турски
peas	грах
man	мъж
die	зар
net	мрежа
Islam	Мека
praise	хвала
human	човек
so	та
sentence	изречение
bomb	бомба
rank	сан
lesson	урок
varnish	лак
crawfish	рак
stream	поток
hay	сено
meteor	метеор
moment	миг
committee	комитет
кой	кого
male student	студент
interest	интерес
journal	журнал
hero	герой
history	история
school	училище
older sister	кака
second	секунда
month	месец
year	година
slave	роб
neither	ни
caraway	ким
male physician	лекар
conversation	беседа
dough	тесто
butter	масло
many	много
against	против
wreck	авария
mud	кал
princess	княгиня
straw	слама
croak	грач
three hundred	триста
chirp	чик-чирик
grandson	внук
mouth	уста
lev	лев
work	труд
great crested grebe	шутка
beam	греда
granddaughter	внучка
jackdaw	чавка
Англия	за
soap	сапун
chicken	пиле
wasp	оса
puffbird	пуховка
makeup	грим
translate	превеждам
page	страница
plane	самолет
up	горе
field	поле
female Austrian	австрийка
male Austrian	австриец
science	наука
lock	брава
my	ми
round	около
republic	република
father	баща
soldier	боец
male cooper	бъчвар
idle	безделнича
kidney	бъбрек
BSP	БСП
absorption	абсорбция
business card	визитка
knot	възел
wind	вятър
barbarian	варвар
faith	вяра
male Greenlander	гренландец
Greek	грък
cream	крем
lamp	лампа
tea-urn	самовар
tennis court	корт
miracle	чудо
waqf	вакъф
bread	леб
full	сит
namesake	адаш
instance	случай
grey	сив
heavy rainfall	туча
religion	религия
lash	шибам
keyboard	клавиатура
chocolate	шоколад
male companion	другар
’s	-ов
seal	печат
Unicode	Уникод
male Avar	авар
steel	челик
object	предмет
sheatfish	сом
mash	каша
American	американец
if	ако
albatross	албатрос
type	тип
seagull	чайка
riddle	загадка
then	то
nation	нация
American	американка
position	положение
attitude	отношение
even	даже
form	форма
wedge	клин
work	дело
number	число
cellar	изба
volcano	вулкан
Albanian	албански
yew	тис
differently	иначе
horn	рог
dawn	утро
yesterday	вчера
silk	свила
production	производство
polonium	полоний
apprentice	чирак
sandwich	сандвич
corporation	корпорация
service	служба
murder	убийство
murderess	убийца
sour cream	сметана
taxi	такси
participle	причастие
instead of	вместо
except	кроме
between	между
above	над
in front of	пред
at	при
on the contrary	напротив
brook	ручей
swamp	блато
infection	инфекция
African	африкански
fruit	плод
early	рано
lady	дама
give	дам
walnut	орех
dinner	обед
officer	офицер
chlorophyll	хлорофил
shop	магазин
embankment	вал
company	компания
rifle	пушка
anatid	утка
warehouse	склад
museum	музей
cinema	кино
pawn	пешка
simply	просто
servant	слуга
Swedish	шведски
fly	муха
room	стая
idea	идея
ambition	амбиция
station	станция
convention	конвенция
position	позиция
constitution	конституция
revolution	революция
darkness	мрак
inclination	склонение
ouch	ой
steering wheel	волан
shuttle	снова
body	труп
bark	кора
day	ден
walk	ход
male bedouin	бедуин
goblin	гоблин
suckling	бозайник
lizard	гущер
nobody	никого
nobody	никому
apostrophe	апостроф
telescope	телескоп
biography	животопис
erudition	ерудиция
decoration	орден
literature	литература
sincere	искрен
line	черта
udarnik	ударник
tramp	бродяга
birch	бреза
long ago	издавна
September	септември
October	октомври
December	декември
November	ноември
creativity	креативност
minus sign	минус
plus sign	плюс
their	им
colon	двоеточие
son-in-law	зет
rule	правило
plough	плуг
riboflavin	рибофлавин
bull	бик
tractor	трактор
translation	превод
strength	сила
window	прозорец
freedom	свобода
for example	например
townsman	гражданин
member	член
pronoun	местоимение
parrot	папагал
shovel	лопата
machine	машина
philosophy	философия
landscape	пейзаж
atom	атом
grampus	косатка
loom	стан
ferry	ферибот
nightmare	кошмар
photographer	фотограф
loan	заем
rent	наем
heathen priest	жрец
scoundrel	подлец
twin	близнец
creator	творец
court	дворец
key	ключ
apple	ябълка
tram	трамвай
map	карта
dew	роса
godlessness	безбожие
entrance	вход
part	част
shelf	полица
sweat	пот
train	влак
tower	кула
attention	внимание
scab	струп
clay	глина
fairy	фея
match	мач
material	материал
rainbow	дъга
pus	гной
donkey	осел
night	нощ
waiter	келнер
waitress	келнерка
pediment	фронтон
ox	вол
anime	аниме
house	къща
butterfly	пеперуда
poison	отрова
flea	бълха
scandium	скандий
vanadium	ванадий
zinc	цинк
germanium	германий
selenium	селен
bromine	бром
krypton	криптон
rubidium	рубидий
strontium	стронций
zirconium	цирконий
niobium	ниобий
molybdenum	молибден
technetium	технеций
ruthenium	рутений
rhodium	родий
cadmium	кадмий
indium	индий
iodine	йод
xenon	ксенон
cesium	цезий
barium	барий
lanthanum	лантан
cerium	церий
praseodymium	празеодим
neodymium	неодим
promethium	прометий
samarium	самарий
europium	европий
gadolinium	гадолиний
terbium	тербий
thulium	тулий
tantalum	тантал
rhenium	рений
osmium	осмий
iridium	иридий
radon	радон
francium	франций
radium	радий
actinium	актиний
thorium	торий
protactinium	протактиний
neptunium	нептуний
plutonium	плутоний
americium	америций
curium	кюрий
berkelium	берклий
californium	калифорний
fermium	фермий
mendelevium	менделевий
nobelium	нобелий
lawrencium	лоуренсий
dubnium	дубний
seaborgium	сиборгий
bohrium	борий
meitnerium	майтнерий
manager	директор
printer	принтер
muezzin	мюезин
mosque	джамия
airplane	авион
reason	разум
degree	градус
government	управление
business	бизнес
coffee	кафе
back	назад
law	закон
physical	физически
Bulgarian	български
ignoramus	невежа
clearly	ясно
action	действие
automaton	автомат
attack	атака
stick	палка
mustard	горчица
mother	майка
that	онзи
that	оня
this	този
this	тоя
ash	пепел
breadth	вис
read	прочета
sweep	мета
prick	бода
weave	вплета
lead	въведа
reproduce	възпроизведа
bring	доведа
sweep up	домета
finish knit	доплета
read	допрочета
stick	забода
take	заведа
begin	замета
start	заплета
begin	запреда
begin	зачета
prick	избода
take out	изведа
sweep	измета
knit	изплета
finish spin	изпреда
read	изчета
steal	крада
stick	набода
bow	наведа
make	наклада
knit	наплета
sweep	насмета
find	начета
fit	обзаведа
rob	окрада
spin	опреда
unpin	отбода
lead	отведа
give	отчета
knit	плета
lead	поведа
mislead	подведа
light	подклада
give	подмета
sweep a little	поизмета
sweep	помета
honour	почета
translate	преведа
spin	преда
weave	вплитам
lead	въвеждам
reproduce	възпроизвеждам
bring	довеждам
sweep up	домитам
finish knit	доплитам
read	допрочитам
stick	забождам
take	завеждам
begin	замитам
start	заплитам
begin	запридам
begin	зачитам
prick	избождам
take out	извеждам
sweep	измитам
knit	изплитам
finish spin	изпридам
read	изчитам
stick	набождам
bow	навеждам
make	наклаждам
knit	наплитам
sweep	насмитам
find	начитам
fit	обзавеждам
rob	окрадвам
sweep	омитам
spin	опридам
unpin	отбождам
lead	отвеждам
give	отчитам
lead	повеждам
mislead	подвеждам
light	подклаждам
give	подмитам
sweep a little	поизмитам
sweep	помитам
honour	почитам
read	прочитам
bring	внеса
standard	стандарт
bring	внасям
offer	възнеса
offer	възнасям
bring	донеса
bring	донасям
contribute	допринеса
contribute	допринасям
carry	занеса
carry	занасям
begin	затреса
begin	затрисам
take out	изнеса
take out	изнасям
graze bare	изпаса
graze bare	изпасвам
deposit	надвнеса
deposit	надвнасям
bring	надонеса
bring	надонасям
terror	ужас
bake	допека
bake	допичам
axe	секира
evil	зло
come	дотека
come	дотичам
brown	запека
brown	запичам
implore	зарека
implore	заричам
start run	затека
start run	затичам
dot	точка
quark	кварк
great-	пра-
problem	проблем
opera	опера
music	музика
petrol	бензин
bake	изпека
bake	изпичам
pronounce	изрека
pronounce	изричам
flow out	изтека
flow out	изтичам
bake	напека
bake	напичам
call	нарека
call	наричам
promise	обрека
promise	обричам
bake	опека
bake	опичам
swell	отека
swell	отичам
deny	отрека
deny	отричам
bake	понапека
bake	понапичам
bake partly	поопека
bake partly	поопичам
platoon	взвод
detachment	отряд
swell a little	поотека
swell a little	поотичам
warm	попека
warm	попичам
run	потека
run	потичам
predict	предрека
predict	предричам
overdo	препека
overdo	препичам
moon	месечина
rich	богат
movement	движение
pistol	пистолет
roast	припека
roast	припичам
ensue	произтека
ensue	произтичам
flow	протека
flow	протичам
cake	спека
cake	спичам
bake	пека
flow	тека
bring	нанеса
bring	нанасям
graze	опаса
graze down	опасвам
homosexuality	хомосексуалност
mouse	глушец
radio	радио
task	задача
factory	фабрика
beating	бой
slogan	лозунг
cupboard	шкаф
singer	певец
singer	певица
IPA	МФА
thread	конец
bedroom	соба
beginning	начало
truth	правда
artist	художник
monkey	маймуна
silence	тишина
Czech	чешки
head	глава
woman	жена
wheat	жито
field	нива
wing	крило
sister	сестра
truth	истина
herd	стадо
village	село
penis	пенис
brick	тухла
adobe	кирпич
grapevine	лоза
time	доба
deca-	дека-
goat	коза
face	лице
furrow	бразда
blood vessel	жила
moisture	влага
wound	рана
crying	плач
cursory	бегъл
a bit slow	бавничък
a bit poor	бедничък
clear	бистър
palish	бледничък
quite close	близичък
near	близък
lively	бодър
a bit sick	болничък
barefoot	босичък
quite fast	бързичък
abdominal	абдоминален
subscription	абонаментен
abrasive	абразивен
absolute	абсолютен
abstract	абстрактен
absurd	абсурден
advance-guard	авангарден
adventurous	авантюристичен
aviation	авиационен
authentic	автентичен
abbot	абатски
Abyssinian	абисински
graduation	абитуриентски
Abkhazian	абхазки
aboriginal	аборигенски
graduation	абсолвентски
Avar	аварски
august	августейши
August	августовски
airman	авиаторски
pail	ведро
yoke	иго
shoulder	рамо
pit	яма
chin	брада
hoarfrost	слана
diaper	пелена
cheek	ланита
bottom	дъно
court	двор
diary	дневник
mineralogy	минералогия
building	здание
draft	течение
abacus	абак
one	единица
medicine	лекарство
medicine	медицина
moment	момент
ebony	абаносов
advance	авансов
Augean	авгиев
Adam	адамов
аsbestos	азбестов
nitrous	азотист
alarm	алармен
scarlet	ален
alto	алтов
aluminium	алуминиев
whitish	възбял
largish	възголям
deaf-mute	глухоням
big	голям
left	ляв
milk-white	млечнобял
indirect	непряк
unboiled	неврял
not big	неголям
underdone	недоврял
tax	налог
fool	глупец
abyss	бездна
Albanian man	албанец
Albanian woman	албанка
snake	змия
where	къде
plant	растение
throne	престол
exhaustion	умора
nature	природа
decision	решение
temperature	температура
male animal	самец
rose	роза
amethyst	аметист
axe	топор
violence	насилие
unbelieving	безверен
mad	бесен
true	верен
second-rate	второразреден
rather tight	възтесен
right	десен
iron	железен
summer	летен
suprapatellar	надколенен
false	неверен
popliteal	подколенен
fresh	пресен
anti-rabies	противобесен
first-rate	първоразреден
sulphur	серен
narrow	тесен
third-rate	треторазреден
break-down	авариен
anti-party	антипартиен
bacterial	бактериен
battery	батареен
battery	батериен
flawless	безавариен
countless	безброен
inactive	бездеен
lack	безидеен
endless	безкраен
outpost	аванпост
own goal	автогол
ham	шунка
news	новост
larva	личинка
strict	строг
divorce	развод
cunning	лукав
skew	крив
carrot	морков
propaganda bureau	агитпункт
coast	бряг
running	бяг
hydrophobia	бяс
anger	гняв
sin	грях
Central Europe	Централна Европа
laughter	смях
snow	сняг
cure	цяр
garden	градина
battleship	броненосец
wreath	венец
sparrow	врабец
healer	вражалец
bell	звънец
slanderer	злословец
tooth	зъбец
well	кладенец
nail	клинец
aerometer	аерометър
algorithm	алгоритъм
ammeter	амперметър
amphitheatre	амфитеатър
anemometer	анемометър
ensemble	ансамбъл
male arbiter	арбитър
audiometer	аудиометър
male student	бакалавър
barometer	барометър
binoculars	бинокъл
biocomputer	биокомпютър
beaver	бобър
brontosaurus	бронтозавър
acute accent	´
victory	победа
anachronism	анахронизъм
anglicism	англицизъм
archaism	архаизъм
atavism	атавизъм
aphorism	афоризъм
vulgarism	вулгаризъм
grecism	гърцизъм
French idiom	галицизъм
euphemism	евфемизъм
euphuism	евфуизъм
male Australian	австралиец
male Alpine dweller	алпиец
male Aryan	ариец
male Assyrian	асириец
male Belgian	белгиец
male	белогвардеец
male deicide	богоубиец
male fratricide	братоубиец
jug	кана
person	агитпропчик
male agnostic	агностик
male agricultural technician	агротехник
male agricultural chemist	агрохимик
alphabetical index	азбучник
male alchemist	алхимик
rosemary	розмарин
male agrobiologist	агробиолог
equivalent	аналог
male anaesthetist	анестезиолог
male anthropologist	антрополог
sweatsuit	анцуг
male archeologist	археолог
archipelago	архипелаг
male astrologer	астролог
male bacteriologist	бактериолог
almanac	алманах
male Wallachian	влах
eunuch	евнух
exarch	екзарх
stroke	замах
hierarch	йерарх
fur coat	кожух
monarch	монарх
monk	монах
oligarch	олигарх
sultan	падишах
patriarch	патриарх
poor man	сиромах
stomach	стомах
rumen	търбух
male Avar	аварин
male agent	агентин
male Arab	арабин
male farmhand	аргатин
male arnaut	арнаутин
soldier	аскерин
male black man	арапин
male Athenian	атинянин
number	брой
bark	лай
swarm	рой
sediment	слой
stock	сой
system	строй
hippopotamus	бегемот
shackles	окови
sonnet	сонет
chord	хорда
long undershirt	риза
carrion	леш
paternal aunt	стрина
today	днес
because	понеже
spring	пролет
quantity	количество
male German	немец
husband	съпруг
turkey-hen	пуйка
computer	компютър
blood	кръв
mouse	мишка
animal	животно
picture	картина
argument	спор
argument	аргумент
east	изток
good	добро
plum	слива
tin	калай
lemon	лимон
cinnamon	канела
talk	разговор
antioxidant	антиокислител
male germ-carrier	бацилоносител
vane	ветропоказател
video accelerator	видеоускорител
loudspeaker	високоговорител
water outlet	водоизпускател
cruel	жесток
hardener	втвърдител
hovel	бордей
swift current	бързей
orderly	вестовой
video display	видеодисплей
run	бягам
run	тичам
threat	угроза
iron	желязо
blanket	одеяло
falcon	сокол
watering-place	водопой
nail	гвоздей
feast	гуляй
duel	двубой
Turkish feudal governor	деребей
sugar	захар
prince	принц
nut	гайка
stallion	жребец
tree	дърво
upward slope	скат
male Azerbaijani	азербайджанец
agha	ага
sturdy	бабанка
noble	велможа
bishop	владика
sage	влъхва
voivode	войвода
journeyman	калфа
male colleague	колега
elder brother	байко
uncle	байно
male coward	бъзльо
male blab	бърборко
miser	вариклечко
male know-it-all	всезнайко
offer	предложение
mood	настроение
idiot	идиот
hen	кокошка
worm	червей
spoilt	глезльо
silly	глупчо
brother-in-law	драгинко
globe	глобус
desire	желание
geography	география
success	успех
flower	цвете
sperm	сперма
cheers	наздраве
taste	вкус
aster	богородичка
young lady	госпожица
beautiful woman	красавица
mother	майчица
politician	политик
little sister	сестрица
little sister	сестричка
beautiful woman	хубавелка
attractive woman	хубавица
female scamp	хубостница
treachery	измяна
unfaithfulness	изневяра
barbel	мряна
exchange	обмяна
help	отмяна
substitution	подмяна
attire	премяна
change	промяна
exchange	размяна
turnip	ряпа
property	имущество
change	смяна
eaves	стряха
separation	раздяла
property	свойство
neutrality	неутралност
sport	спорт
friendship	дружба
countermeasure	контрамярка
measure	мярка
shade	отсянка
half measure	полумярка
penumbra	полусянка
chiaroscuro	светлосянка
shade	сянка
abdication	абдикация
abduction	абдукция
aberration	аберация
ablactation	аблактация
abrasion	абразия
abstraction	абстракция
sword	сабя
span	педя
nuisance	беля
sister-in-law	буля
will	воля
quince	дюля
goad	копраля
shirt	кошуля
distaff-ful	къделя
aunt	леля
absoluteness	абсолютност
absurdness	абсурдност
authenticity	автентичност
authoritativeness	авторитетност
definition	определение
income	доход
aggressiveness	агресивност
adequacy	адекватност
activity	активност
actuality	актуалност
accuracy	акуратност
tent	палатка
promise	обещание
audience	публика
manufacturing	абаджийство
abbey	абатство
authorship	авторство
propaganda poster	агиттабло
agronomy	агрономство
antibody	антитяло
summer	лято
milk	мляко
body	тяло
place	място
reptile	влечуго
duckweed	водорасло
cephalopod	главоного
mollusc	мекотело
multiplicand	множимо
insect	насекомо
laxative	очистително
laxative substance	разхлабително
licence	позволително
adjective	прилагателно
permit	разрешително
predicate	сказуемо
addend	събираемо
substantive	съществително
minuend	умаляемо
arthropod	членестоного
aboriginal child	аборигенче
avenue	авеню
air taxi	авиотакси
automotive	автомобилостроене
small car	автомобилче
lamb	агне
air taxi	аеротакси
acne	акне
procedure	процедура
burden	бреме
time	време
flag	знаме
tribe	племе
half time	полувреме
seed	семе
stirrup	стреме
abdication	абдикиране
subscription	абониране
this	тази
him	го
distant	далечен
plough	рало
graveyard	гробище
dwelling	жилище
settlement	селище
abortion	абортиране
absolutization	абсолютизиране
absorption	абсорбиране
medical	балнеолечение
vigil	бдение
celibacy	безбрачие
sore	язва
fence	ограда
sweep	омета
take	отнеса
take	отнасям
board	дъска
fracas	крамола
open exterior platform	полата
interest	лихва
beauty	красота
hope	надежда
male boss	шеф
graze	паса
present	поднеса
drag along	понеса
stun	потреса
exalt	превъзнеса
carry	пренеса
bring	привнеса
bring	принеса
pronounce	произнеса
begin	пронеса
carry	разнеса
lay	снеса
shake	треса
carry away	унеса
draw	въвлека
draw	въвличам
drag up	довлека
drag up	довличам
drag away	завлека
drag away	завличам
begin	засека
begin	засичам
pull out	извлека
pull out	извличам
fell	изсека
fell	изсичам
slip on	навлека
slip on	навличам
put on	наоблека
put on	наобличам
cut	насека
cut	насичам
put on	облека
put on	обличам
carry off	отвлека
carry off	отвличам
cut off	отсека
cut off	отсичам
stone	камък
lake	езеро
abortion	аборт
car	автомобил
shepherd	пастир
male shepherd	чобан
bread	хляб
buffalo	бивол
caress	ласка
paper	хартия
quantity	величина
adverb	наречие
cause	причина
fact	факт
male lawyer	адвокат
plan	план
broom	метла
availability	наличие
jazz	джаз
feeling	чувство
thank you	благодаря
delirium	делир
hardly	едва
conduct	поведение
commodity	товар
Chinese	китаец
perfect	съвършен
starling	скорец
cage	клетка
ticket	билет
amnesty	амнистия
race	раса
continent	континент
sieve	решето
mom	мамин
capital	столица
nightingale	славей
suit	костюм
alibi	алиби
study	кабинет
desk	бюро
warrior	воин
principle	принцип
practice	практика
male pupil	ученик
beach	плаж
pike	щука
mask	маска
neck	гуша
needle	игла
visa	виза
piece	парче
exactly	точно
crow	врана
thou	ти
your	ви
heel	пета
goose	гъска
hole	лам
uncastrated ram	коч
cannon	топ
internet	интернет
sky	небе
hat	шапка
tongue	език
pigeon	гълъб
red	червен
write	пиша
duck	патица
chain	верига
family	семейство
incense	пожар
light	светлина
substance	вещество
scissors	ножица
heart	сърце
box	кутия
important	важен
count	граф
party	партия
civilization	цивилизация
peach	праскова
teapot	чайник
line	линия
half	половина
punishment	наказание
curse	проклятие
drag	повличам
drag	повлека
eel	змиорка
sacrifice	жертва
antelope	антилопа
farm	ферма
pornography	порнография
virus	вирус
superstition	суеверие
chemist	химик
fibre	нишка
male aborigine	абориген
basket	кошница
chisel	длето
dale	дол
stake	кол
trough	корито
male adventurer	авантюрист
adventuress	авантюристка
canvas	платно
battle	сражение
timepiece	часовник
bench	лавка
egg	яйце
large lamb	агнец
swan	лебед
snail	охлюв
cattle	говедо
mare	кобила
ant	мравка
carp	шаран
crocodile	крокодил
turtle	костенурка
eagle owl	бухал
hit	удар
jay	сойка
magpie	сврака
lift	асансьор
strawberry	ягода
ginger	джинджифил
bassoon	фагот
thrush	дрозд
participation	участие
orthography	правопис
headache	главоболие
hornet	стършел
journalist	журналист
hummingbird	колибри
sparrow	врабче
swallow	лястовица
tit	синигер
necktie	вратовръзка
amusement	забава
basket	кош
noise	шум
creature	твар
robe	роба
stadium	стадион
border	гранича
final	абитуриентка
lid	капак
male communist	комунист
Ukrainian	украинец
Ukrainian	украинка
mackerel	скумрия
candle	свещ
preacher	проповедник
hemp	коноп
absolute	абсолют
Palestine	Палестина
Aristotle	Аристотел
sulk	цупя се
abrasive	абразив
pearl	бисер
hatred	омраза
male driver	шофьор
snowflake	снежинка
frieze	аба
bolt	нит
calf	теле
virgin	девица
furrow	улей
person	особа
object	нещо
crown	корона
communism	комунизъм
document	документ
artichoke	артишок
healthy	здрав
velvet	кадифе
robot	робот
lion	лъв
grass	трева
speech	реч
bed	легло
grandfather	дядо
rope	въже
fleece	руно
wax	восък
adrenaline	адреналин
child	чедо
daughter	дъщеря
poplar	топола
gas burner	горелка
statute	устав
quotation	цитат
air	въздух
priest	свещеник
hamster	хомяк
elbow	лакът
wife	съпруга
sand	пясък
want	искам
pail	кофа
hoof	копито
hunger	глад
memory	памет
shame	срам
nest	гнездо
dragon	змей
police	полиция
fuck	еба се
ladybird	калинка
do you speak English	говорите ли английски
colt	жребче
death	смърт
Persephone	Персефона
pretty	хубав
considerable	значителен
male friend	приятел
long	дълъг
wide	широк
thick	плътен
thick	дебел
heavy	тежък
small	малък
small	дребен
short	кратък
thin	тънък
weak	слаб
daddy	татко
wild animal	звяр
cur	псе
louse	въшка
abbreviation	абревиатура
abscissa	абсциса
female Abyssinian person	абисинка
female student graduating university	абсолвентка
proscenium	авансцена
airwoman	авиаторка
air bomb	авиобомба
oriole	авлига
female Australian	австралийка
motor-service station	автобаза
automatic block system	автоблокировка
bus station	автогара
motor-trolley	автодрезина
motor transport column	автоколона
freeway	автомагистрала
electric	автомотриса
authoress	авторка
motor road	автострада
female agent	агентка
female propagandist	агитаторка
propaganda text	агитка
Netherlands	Холандия
niece	племенница
commercial	комерсиален
agora	агора
female aggressor	агресорка
female agronomist	агрономка
female Adventist	адвентистка
female lawyer	адвокатка
female administrator	администраторка
airport	аерогара
aerophotograph	аероснимка
female Azerbaijani	азербайджанка
female person	азиатка
female watercolour painter	акварелистка
female accordionist	акордеонистка
acrobatics	акробатика
female acrobat	акробатка
axiom	аксиома
female activist	активистка
actress	актриса
midwife	акушерка
asbestos	азбест
give me	дайте ми
kill	убивам
how are you	как си
alarm	аларма
tradition	традиция
alveolus	алвеола
halberd	алебарда
female native	алжирка
crazy	луд
cloak	плащ
ruddy	румен
bath	баня
ass	гъз
chasm	пропаст
scarf	шарф
towel	пешкир
armchair	кресло
lecture	лекция
scandal	афера
survey	анкета
hearing	слух
cinnamon	дарчин
park	парк
grave	гроб
file	файл
sock	чорап
shawl	шал
ring	халка
aerial	антена
beverage	напитка
beverage	питие
individuality	индивидуалност
поради́ това́	поради това
ask	питам
ask	моля
baby	бебе
tiger	тигър
ready	готов
last year	лани
example	пример
male opponent	противник
passage	проход
radar	радар
development	развитие
barn	хамбар
ostrich	щраус
shit	лайно
spider	паяк
refrain	припев
male killer	убиец
exhaustion	мор
hold back	възпра
hold back	възпирам
touch	допра
touch	допирам
thrust	завра
thrust	завирам
suspect	заподозра
suspect	заподозирам
stop	запра
stop	запирам
sight	зра
stick	навра
stick	навирам
prop	опра
prop	опирам
prop	подпра
prop	подпирам
stop	поспра
stop	поспирам
despise	презра
despise	презирам
insist	припра
insist	припирам
shove	провра
shove	провирам
see	прозра
see	прозирам
stretch out	простра
stretch out	простирам
spread	разпростра
spread	разпростирам
thrust	свра
thrust	свирам
stop	спра
stop	спирам
catch sight	съзра
catch sight	съзирам
stick	вра
thrust	въвра
thrust	въвирам
die down	замра
die down	замирам
perish	измра
perish	измирам
die	мра
die away	отмра
die away	отмирам
faint	премра
faint	премирам
die	примра
die	примирам
die	умра
die	умирам
drive	вковавам
start rowing	загребвам
nail	заковавам
begin	заоравам
begin	заревавам
call	зова
scrape	изгребвам
finish gnawing	изгризвам
forge	изковавам
suddenly	внезапно
arch	арка
plough up	изоравам
roar out	изревавам
drop	изтървавам
scoop up	нагребвам
nibble	нагризвам
call	назовавам
fasten	наковавам
bird	накълвавам
plate	обковавам
ground	обосновавам
amethyst	аметистов
ammonium	амониев
pineapple	ананасов
embassage	вест
habit	адет
tuberculosis	туберкулоза
caste	каста
anise	анасонов
aniline	анилинов
angry	сърдит
angry	гневен
curd cheese	сирене
beautiful	красив
noble	благороден
male dentist	зъболекар
gorilla	горила
beautiful	прекрасен
beautiful	чудесен
supernatural	свръхестествен
skilful	майсторски
brave	храбър
reckless	безразсъден
brave	смел
fearless	безстрашен
resolute	решителен
firm	непоколебим
energetic	енергичен
undoubted	несъмнен
valiant	доблестен
glorious	славен
brave	храбрец
hero	юнак
attentive	внимателен
cautious	предпазлив
assiduous	старателен
careful	грижлив
zealous	усърден
polite	учтив
evasive	уклончив
exact	точен
accurate	акуратен
full	пълен
entire	цял
detailed	подробен
thorough	щателен
untouched	непокътнат
true	истински
creative	креативен
authoritative	авторитетен
aggressive	агресивен
adequate	адекватен
active	активен
topical	актуален
practical	практичен
feasible	изпълним
possible	възможен
probable	вероятен
feasible	осъществим
applicability	приложимост
possibility	възможност
feasibility	осъществимост
feasibility	изпълнимост
chance	вероятност
practicalness	практичност
careless	небрежен
careless	невнимателен
carelessness	небрежност
carelessness	невнимателност
attentiveness	внимателност
carefree	безгрижен
care	грижа
anxiety	безпокойство
alarm	тревога
flighty	лекомислен
flightiness	лекомислие
care	безгрижие
easy	лесен
nimbleness	лекота
nimble	пъргав
fast	бърз
industrious	работлив
elastic	еластичен
flexible	гъвкав
agility	пъргавина
agility	пъргавост
pray	моля се
wonder	питам се
enlist	пиша се
kill	убия
serious	несериозен
seriousness	несериозност
unimportant	неважен
unreliable	ненадежден
unreliability	ненадеждност
promising	надежден
reliability	надеждност
serious	сериозен
seriousness	сериозност
unripe	неузрял
inexperienced	неопитен
inexperience	неопитност
experienced	опитен
experience	опитност
attempt	опит
effort	усилие
enter	вляза
enter	влизам
amount	възляза
amount	възлизам
set	заляза
set	залязвам
exit	изляза
exit	излизам
make	навляза
make	навлизам
come out	наизляза
come out	наизлизам
make	понавляза
make	понавлизам
derive	произляза
derive	произлизам
move	сляза
move	слизам
lay	снасям
pick	бера
learn	уча
learn	уча се
teach	обучавам
teach	обуча
carry away	унасям
suffering	страдание
spread	мажа
crush	смазвам
crush	смажа
put out	потуша
put out	потушавам
deceit	измама
reality	действителност
real	действителен
reality	реалност
real	реален
be	съм
chew	дъвча
male translator	преводач
lease	наемам
drip	капя
live	живея
substance	материя
thresh	вършея
sing	пея
play	играя
dance	танцувам
lengthen	продължа
lengthen	продължавам
wait	чакам
expect	очаквам
truth	истинност
veracious	истинен
intelligent	интелигентен
intelligence	интелигентност
clever	умен
erudition	образованост
sensible	разумен
intellect	интелект
reasonableness	разумност
wise	мъдър
wisdom	мъдрост
judicious	разсъдлив
judiciousness	разсъдливост
prudence	благоразумие
reasonable	благоразумен
judicious	разсъдителен
judiciousness	разсъдителност
unreasonableness	неразсъдителност
unreasonable	неразсъдителен
unreasonable	неразсъдлив
unreasonableness	неразсъдливост
unreason	неразумност
imprudence	неблагоразумие
unwise	неразумен
imprudent	неблагоразумен
shrewd	проницателен
perspicacity	проницателност
realistic	реалистичен
material	веществен
materiality	вещественост
valid	валиден
validity	валидност
skill	вещина
competent	компетентен
competence	компетентност
aristocracy	аристокрация
competence	компетенция
adroit	умел
agile	ловък
skilful	сръчен
capable	кадърен
able	способен
skilful	изкусен
sweet	сладък
kindle	запалвам
why	защо
awkward	неумел
kindle	запаля
awkward	неловък
unskilful	несръчен
aesthetic	естетичен
heron	чапла
clean	чист
incompetent	некадърен
incompetent	некомпетентен
woodpecker	кълвач
squirrel	катерица
swine	свиня
high	висок
unable	неспособен
unskilful	неизкусен
girlfriend	гадже
fool	абдал
look for	търся
ability	умелост
dexterity	ловкост
dexterity	сръчност
dawn	зора
lip	устна
steel	стомана
male enemy	неприятел
roof	покрив
maize	царевица
beans	фасул
male rival	съперник
Christ's thorn	драка
peninsula	полуостров
leech	пиявица
stench	смрад
badger	язовец
pouch	торба
coupon	купон
receipt	талон
cherry	череша
garment	гуна
fire	огън
partridge	яребица
cheek	буза
mausoleum	мавзолей
ram	овен
captain	капитан
end	край
cave	пещера
textbook	учебник
lark	чучулига
octopus	октопод
hyperbola	хипербола
volt	волт
spot	шар
bush	храст
parachute	парашут
hail	градушка
young	млад
mine	рудник
top	връх
back	гръб
accuse	коря
fly	летя
silent	мълча
milk	доя
consider	имам се
и́мам се	имам се с някого
jurist	юрист
Ivanov	Иванов
lord	лорд
grenade	граната
brigade	бригада
armor	броня
army	войска
hamlet	вес
character	характер
formation	образование
impression	впечатление
knowledge	знание
just	именно
institute	институт
boat	лодка
reporter	репортер
department	отдел
helper	помощник
portrait	портрет
enterprise	предприятие
worker	работник
stage	сцена
condition	условие
grand	бон
that	що
kangaroo	кенгуру
meadow	ливада
opening	отвор
weapon	оръжие
Russian	русин
phoenix	феникс
deity	богиня
editing	редактиране
colonel	полковник
platypus	птицечовка
bill	човка
beak	клюв
such as	като
when	когато
late	късно
cut	купюр
execution	разстрел
afternoon	следобед
afternoon	подиробед
through	през
orgasm	оргазъм
scenario	сценарий
trophy	трофей
ambassador	посол
situation	ситуация
watt	ват
horseradish	хрян
hippopotamus	хипопотам
similar	подобен
expensive	скъп
farmer	фермер
rob	грабя
destroy	унищожавам
odd	чудат
pharaoh	фараон
product	творение
beak	клюн
добъ́р ве́чер	добър вечер
dirigible	дирижабъл
package	пакет
information	информация
OK	окей
cut	купюра
space	простор
pretext	предлог
cleavage	разлог
knot	възлите
knot	възли
turbot	калкан
joy	радост
contract	договор
balustrade	балюстрада
illness	болест
passport	паспорт
-ish	-лив
operating system	операционна система
moustache	мустак
abbot	абат
travel	пътувам
rain	дъжд
lightning	мълния
sleet	суграшица
ode	ода
decide	реша
universal joint	кардан
Armenian	арменски
Armenian	арменец
Armenian	арменка
February	февруари
mobile phone	мобилен телефон
when	кога
generalissimo	генералисимус
way	начин
secondary school	гимназия
Slovenian	словенски
cigarette	цигара
heaven	рай
identity card	лична карта
international	интернационален
ashtray	пепелник
lighter	запалка
Baroque	барок
harpsichord	чембало
male agronomist	агроном
helicopter	хеликоптер
vehicle	возило
similarity	прилика
male acrobat	акробат
chord	акорд
male agent	агент
male activist	активист
alarm clock	будилник
pencil	молив
pencil sharpener	острилка
acoustics	акустика
accumulator	акумулатор
king	кралски
here	тука
foliage	шума
small	мал
tail	опашка
filament	влакно
Hungarian	унгарски
agreement	единство
tit	цица
plague	чума
hamburger	хамбургер
frost	мраз
autumn	есен
universe	вселена
motorcycle	мотоциклет
male drug addict	наркоман
load	заредя
destroy	унищожа
thunder	гръм
centre	център
epicentre	епицентър
film center	киноцентър
radio centre	радиоцентър
television centre	телецентър
smoke	дим
decilitre	децилитър
decimetre	дециметър
kilometre	километър
litre	литър
dessert	десерт
millimetre	милиметър
millilitre	милилитър
log	дебло
centilitre	сантилитър
centimetre	сантиметър
hectolitre	хектолитър
hectometre	хектометър
decalitre	декалитър
kilolitre	килолитър
megalitre	мегалитър
gigalitre	гигалитър
teralitre	тералитър
petalitre	петалитър
exalitre	ексалитър
yottalitre	йоталитър
microlitre	микролитър
nanolitre	нанолитър
picolitre	пиколитър
femtolitre	фемтолитър
attolitre	атолитър
zeptolitre	септолитър
yoctolitre	йоктолитър
megametre	мегаметър
gigametre	гигаметър
terametre	тераметър
petametre	петаметър
exametre	ексаметър
zettametre	сетаметър
yottametre	йотаметър
micrometre	микрометър
nanometre	нанометър
picometre	пикометър
femtometre	фемтометър
attometre	атометър
zeptometre	септометър
yoctometre	йоктометър
young man	момък
male fugitive	беглец
dead man	мъртвец
male Turk	турчин
leg	крак
electron	електрон
karate	карате
prince	княз
colleague	събрат
quay	кей
spray	спрей
nail	нокът
crossroads	кръстопът
field	кър
road	път
half	полусън
sleep	сън
paradox	парадокс
song	песен
thought	мисъл
lapse	лапсус
temptation	съблазън
string	връв
grief	скръб
bait	стръв
sphere	кълбо
hemisphere	полукълбо
thigh	бедро
smell	мирис
prison	затвор
anaconda	анаконда
mental image	представа
anathema	анатема
crisis	криза
knee	коляно
battle	битка
fisherman	рибар
coal	въглища
shorts	гащета
little children	дечица
kids	дечурлига
shoes	обуща
spectacles	очила
folk	хорица
underpants	гащи
earthenware	грънци
data	данни
portals	двери
ancestors	деди
abdicate	абдикирам
jeans	джинси
jeans	дънки
pliers	клещи
panties	кюлоти
long pants	наполеонки
annul	анулирам
fruit trees	овощия
ancestors	прадеди
forefathers	предци
spaghetti	спагети
finance	финанси
tights	чорапогащи
shorts	шорти
potato	картоф
sandal	сандал
tights	чорапогащник
forgiveness	опрощение
accordion	акордеон
foreigner	чужденец
foreigner	чужденка
absorb	абсорбирам
accent	акцент
applaud	аплодирам
after	след
high	висш
sparrow	врабчи
former	бивш
low	низш
organ	орган
computation	рачун
fight	борба
tourist	турист
оби́чам те	обичам те
male actor	актьор
cheap	евтин
anchovy	аншоа
acorn	жълъд
low	нисш
college	полувисш
audacious	дързък
ram	кочи
cuckoo	кукувичи
cuckoo	кукувица
dog	кучи
mole	къртичи
swallow	лястовичи
sheep	овчи
turkey	пуйчи
magpie	сврачи
hen	кокоши
proton	протон
physicist	физик
positron	позитрон
photon	фотон
neutron	неутрон
Bulgarian muslim	помак
old age	старост
mistake	грешка
aggression	агресия
pale	бледосин
bluish	възсин
navy blue	морскосин
sky-blue	небесносин
light	светлосин
dark blue	тъмносин
goat	кози
cow	крави
horizon	хоризонт
consequence	последица
foundation	основа
reflex	рефлекс
ethics	етика
aggregate	агрегат
male weaver	абаджия
abasia	абазия
ebony	абанос
cane	бастун
stick	пръчка
fruit tree	овошка
bone	кокал
fat	мазнина
joke	виц
glad	рад
witness	сведок
alternative	алтернатива
anonymous	анонимен
address	адресирам
allegory	алегория
administration	администрация
admiral	адмирал
advance	авансирам
professor	професор
agency	агенция
ambitious	амбициозен
amen	амин
ammonia	амоняк
flat	апартамент
appetite	апетит
appeal	обръщение
sermon	проповед
pay	предплащам
pay	предплатя
make progress	напредвам
make progress	напредна
precedence	преднина
alcohol	алкохол
arrive	пристигам
male refugee	бежанец
arrest	арест
male alcoholic	алкохолик
antique	антика
protest	протест
sumo	сумо
model	модел
anniversary	юбилей
male	управител
female manager	управителка
female alcoholic	алкохоличка
male pornographer	порнограф
alum	стипца
anise	анасон
coffin	ковчег
command	заповед
arrogance	арогантност
apparatus	апарат
expression	израз
female refugee	бежанка
female drug addict	наркоманка
arrive	пристигна
male inventor	изобретател
female weaver	абаджийка
male Abyssinian	абисинец
apathy	апатия
aroma	аромат
aromatic	ароматен
aromatic	ароматичен
female inventor	изобретателка
male student graduating university	абсолвент
female Avar	аварка
result	резултат
allspice	бахар
male propagandist	агитатор
female agnostic	агностичка
male aggressor	агресор
female agrobiologist	агробиоложка
female agricultural technician	агротехничка
female agricultural chemist	агрохимичка
male Adventist	адвентист
male person	азиатец
artillery	артилерия
gymnastics	гимнастика
male watercolour painter	акварелист
male accordionist	акордеонист
piglet	прасе
male obstetrician	акушер-гинеколог
male native	алжирец
female Alpine dweller	алпийка
female alchemist	алхимичка
covetousness	алчност
female anaesthetist	анестезиоложка
female anthropologist	антроположка
female Arab	арабка
black man	арап
black woman	арапка
female arbiter	арбитърка
male farmhand	аргат
female farmhand	аргатка
female Aryan	арийка
junta	хунта
male arnaut	арнаут
female arnaut	арнаутка
female archeologist	археоложка
female Assyrian	асирийка
army	аскер
female astrologer	астроложка
female Athenian	атинянка
dialect	диалект
female student	бакалавърка
female bacteriologist	бактериоложка
adaptation	адаптация
flea market	битпазар
analytic	аналитичен
arsenal	арсенал
female aborigine	аборигенка
appetizing	апетитен
analytic	аналитически
female germ-carrier	бацилоносителка
female fugitive	бегълка
grammar	граматика
group	група
export	износ
region	регион
transport	транспорт
rich man	богаташ
class	класа
firm	фирма
choice	избор
brush	четка
embroider	веза
female bedouin	бедуинка
female Belgian	белгийка
female	белогвардейка
female deicide	богоубийца
blaze	жар
parasite	паразит
axis	ос
female fratricide	братоубийца
female coward	бъзла
female blab	бърборка
wire	жица
female cooper	бъчварка
female barbarian	варварка
female Wallachian	влахиня
female know-it-all	всезнайка
she-wolf	вълчица
heroine	героиня
spoilt	глезла
lady	госпожа
female Greenlander	гренландка
female pigeon	гълъбица
gander	гъсок
female companion	другарка
male frog	жабок
female rabbit	зайка
female doctor	докторка
dragoness	змеица
covetous	алчен
female dentist	зъболекарка
female colleague	колежка
female butcher	колачка
communist	комунистка
tomcat	котарак
queen	кралица
handsome man	красавец
bitch	кучка
female woodpecker	кълвачка
syringe	шприц
daughter-in-law	снаха
amortization	амортизация
female physician	лекарка
male fox	лисугер
lioness	лъвица
she-ass	магарица
male bear	мечок
male mouse	мишок
young woman	мома
nun	монахиня
female enemy	неприятелка
female eagle	орлица
eaglet	орле
drake	паток
nephew	племенник
female translator	преводачка
female friend	приятелка
female opponent	противница
female opponent	противничка
immature	пуйче
turkey-cock	пуяк
drone	търтей
female destitute	сиромахкиня
female elephant	слоница
elephant calf	слонче
female falcon	соколица
female rival	съперница
female rival	съперничка
sofa	диван
tigress	тигрица
female Turk	туркиня
female hippopotamus	хипопотамка
female homosexual	хомосексуалистка
lesbian	лесбийка
handsome man	хубавеляк
good-looking man	хубавец
destitution	сиромашия
male scamp	хубостник
princess	царкиня
male shepherd	чобанин
female shepherd	чобанка
female boss	шефка
female driver	шофьорка
heroine	юнакиня
guest	гост
hate	мразя
love	обичам
punish	наказвам
punish	накажа
fall in love	влюбвам се
fall in love	влюбя се
sick	болен
love	любов
announcement	съобщение
promise	обещавам
promise	обещая
consent	съгласие
concordant	съгласен
different	различен
buy	купувам
buy	купя
understand	разбирам
understand	разбера
sure	сигурен
agree	съгласявам се
agree	съглася се
refrigerator	хладилник
cold	студен
yellow	жълт
female pupil	ученичка
pupil	ученически
absolutely	абсолютно
power	власт
muscle tissue	мускул
muscular	мускулест
muscle	мускулен
deserve	заслужавам
deserve	заслужа
evil	зъл
happy	щастлив
rose	розов
negative	отрицателен
violet	лилав
prove	доказвам
prove	докажа
poor man	бедняк
poor woman	беднячка
water	воден
mouse	миши
sarcastic	саркастичен
newspaper	вестник
state	държава
government	правителство
government	правителствен
male teacher	учител
female teacher	учителка
male teacher	преподавател
female teacher	преподавателка
male lecturer	лектор
female lecturer	лекторка
teacher	учителски
teacher	преподавателски
lecturer	лекторски
film	филм
pornographic	порнографски
pornographer	порнографка
forbid	забранявам
forbid	забраня
prohibition	забрана
forbids	забранителен
taboo	табу
forget	забравям
oblivion	забрава
become pregnant	забременявам
become pregnant	забременея
pregnant	зачевам
pregnant	зачена
pregnant	бременен
pregnancy	бременност
dentist	зъболекарски
doctor	лекарски
advertising	реклама
bravery	смелост
difference	разлика
resin	смола
doctor	докторски
medical	медицински
nurse	медицинска сестра
male writer	писател
female writer	писателка
writer	писателски
be	писателствам
authorship	писателство
writer	авторски
man	болногледач
woman	болногледачка
nurse	болногледачески
male competitor	състезател
female competitor	състезателка
sheaf	сноп
competition	състезание
competition	състезателен
compete	състезавам се
garage	гараж
alloy	сплав
memory	спомен
first	първи
second	втори
third	трети
fourth	четвърти
sixth	шести
seventh	седми
eighth	осми
ninth	девети
tenth	десети
eleventh	единадесети
бял дроб	бял дроб
lung	белодробен
pulmonary	пулмонален
че́рен дроб	черен дроб
liver	чернодробен
liver	хепатален
old age	старина
old woman	старица
passion	страст
give	давам
sell	продавам
sell	продам
cold	студ
eat	ям
sleep	спя
hair	косъм
hairy	космат
hairy	космест
hairiness	косматост
male seller	продавач
female seller	продавачка
seller	продавачески
sale	продан
sale	продажба
selling	продажбен
sum	сума
dusk	сумрак
table	таблица
patronym	Миков
fall asleep	заспивам
fall asleep	заспя
master	господар
mistress	господарка
master	господарски
burden	тегоба
weigh	тежа
liquid	течност
pumpkin	тиква
survive	оцелявам
survive	оцелея
earthquake	земетресение
earthquake	земетръсен
seismic	сеизмичен
seismicity	сеизмичност
master	господарство
behave	господарствам
господарствам	господарствувам
domineer	господарувам
poisonousness	отровност
dance	танц
toxic	токсичен
toxicity	токсичност
northern	северен
eastern	източен
northwest	северозапад
northwestern	северозападен
northeast	североизток
northeastern	североизточен
male northerner	северняк
female northerner	севернячка
northerner	северняшки
southern	южен
southwest	югозапад
southwestern	югозападен
southeast	югоизток
south-eastern	югоизточен
male southerner	южняк
female southerner	южнячка
southerner	южняшки
western	западен
have breakfast	закусвам
have breakfast	закуся
breakfast	закуска
open	отварям
open	отворя
move	сядам
assume	лягам
go to bed	легна си
go to bed	лягам си
robber	хайдук
put	кача
abdomen	корем
abdominal	коремен
paunchy	коремест
stomach	стомашен
step	стъпало
drink	пия
see	виждам
dry twig	съчка
female breast	гърда
woman	гръд
chest	гръден
гръ́ден кош	гръден кош
busty	гърдест
bless	благославям
bless	благословя
sun	слънце
sun	слънчев
sunniness	слънчевост
слъ́нчев у́дар	слънчев удар
solar system	слънчева система
sunbath	слънчева баня
solar year	слънчева година
solar eclipse	слънчево затъмнение
sunspot	слънчево петно
слъ́нчев спли́т	слънчев сплит
beekeeper	пчелар
rucksack	раница
wound	хапя
wound	ухапвам
wound	ухапя
grip	захапвам
grip	захапя
wound	нахапвам
wound	нахапя
cut off	отхапвам
cut off	отхапя
sever	прехапвам
sever	прехапя
servant	раб
this	таз
sheet	чаршаф
fork	вилица
gold	златен
male German	германец
female German	германка
German	германски
female German	немкиня
German	немски
male Italian	италианец
female Italian	италианка
Italian	италиански
ellipse	елипса
eternity	вечност
steep downhill	рупа
management	управа
male	хулиган
hooliganism	хулиганство
chronicle	хроника
giant	великан
silver	сребърен
poor	беден
command	заповядвам
command	заповядам
phoneme	фонема
strawberry	ягодов
orange	портокал
orange	портокалов
phrase	словосъчетание
intention	намерение
eye	очен
eye socket	очна кухина
о́чен ле́кар	очен лекар
stupid	глуп
dear	драг
blue-eyed	плав
bad	лош
alive	жив
warm-hearted	благ
brotherly	братски
female Jew	еврейка
intact	читав
pornographic	порнографичен
horizontal	водоравен
horizontal	хоризонтален
vertical	отвесен
vertical	вертикален
perpendicular	перпендикулярен
perpendicularity	перпендикулярност
horizontality	водоравност
verticality	отвесност
verticality	вертикалност
orthogonal	ортогонален
orthogonality	ортогоналност
tomato	домат
girl	момиче
article	артикул
angry	ядосан
art	изкуство
rice	ориз
breath	дъх
bass	бас
bet	облог
build	строя
burn	горя
boot	ботуш
bag	чанта
button	копче
democracy	демокрация
warm	топъл
Pole	поляк
asset	актив
backlash	хлабина
arrogant	арогантен
arsenic	арсен
bald	плешив
believe	вярвам
baldness	плешивост
nitric	азотен
often	често
great	велик
open	отворен
official	чиновник
congress	конгрес
danger	опасност
whore	проститутка
classical	античен
shine brightly	сияя
auction	търг
lip	бърна
azalea	азалия
aviation	въздухоплаване
autonomous	автономен
barley	ечемик
boiler water heater	бойлер
idle	ялов
stupid	тъп
bait	примамка
ice	леден
layer	пласт
brazier	мангал
glass	стъкло
exercise book	тетрадка
tip	бакшиш
glue	лепило
schizophrenia	шизофрения
omelette	кайгана
girdle	колан
beetroot	чукундур
shower	душ
male	шизофреник
female	шизофреничка
difficulty	трудно
paradoxical	парадоксален
paradoxical	парадоксалност
conquest	нашествие
volume	том
boy	момче
era	ера
deck	палуба
panic	паника
hill	хрид
forward	напред
measure	мерило
Canadian	канадски
channel	русло
known	познат
written	писмен
narcotic	наркотик
umbrella	чадър
commutation	комутация
Коре́я	Южна Корея
Коре́я	Северна Корея
carcass	арматура
visit	посещение
clause	клауза
castle	замък
complex	сложен
possible	мога
call	повиквам
hello	здравей
hello	здрасти
goodbye	довиждане
добъ́р ден	добър ден
good morning	добро утро
ле́ка нощ	лека нощ
lady	леди
chick	мацка
chieftain	вожд
evidently	очевидно
conjugation	спрежение
mistress	любовница
underwear	бельо
wolf cub	вълче
charge	заряд
ceremony	церемония
back	заднешком
subscription	абонамент
subscriber	абонат
subscribe	абонирам
cavalry	кавалерия
duma	думата
duma	думи
duma	думите
compact	компактен
carrion	мърша
hooligan	хулигански
religious	верски
surely	сигурно
look	поглед
termite	термит
referendum	референдум
chimney	комин
quiet	тих
small star	звездица
resignation	оставка
dress	тоалет
worldly	светски
early	ран
a lot	доста
terribly	ужасно
accumulated professional experience	рутина
concession	концесия
level	ниво
certificate	удостоверение
quality	качество
period	период
fashion	мода
cloaca	клоака
clearing	клиринг
conjuncture	конюнктура
Czech	чех
crest	хребет
beetle	бръмбар
corvid	галун
present participle	че
want	ща
precedent	прецедент
sphere	стихия
ditch	ров
statistics	статистика
hoarfrost	иней
approach	подход
patient	пациент
office	офис
giant	гигант
clown	клоун
magnet	магнит
thirst	жажда
poem	стихотворение
title	заглавие
malefactor	злодей
version	версия
European	Лозенград
dye	боя
lynx	рис
defender	защитник
back	обратно
difference	различие
distinctive characteristic	отличие
bankruptcy	банкрут
ploughman	орач
bribe	подкуп
pear	круша
code	шифър
aquarium	аквариум
deaf	глух
accent	ударение
harvest	урожай
mystery	тайна
gin	джин
contagion	зараза
astrology	астрология
alcoholism	алкохолизъм
gangster	гангстер
citizenship	гражданство
declaration	декларация
udder	виме
forked rod	соха
Jeep	джип
column	колона
tobacco pipe	лула
commitment	ангажимент
jump	скок
successfully	успешно
ordinance	наредба
canteen	чутура
watermill	воденица
railway	железница
clutch	съединител
climate	климат
evenness	равнина
delegate	посланик
dampness	влажност
arrest	арестувам
balance	равновесие
simpleton	простак
strategy	стратегия
sisterly	сестрински
interest	корист
moan	стон
butcher	касапин
until	чак
Brazilian	бразилски
lackey	лакей
brand	клеймо
wire	тел
leader	лидер
diocese	епархия
partisan	поборник
gourmand	яшен
nerve	нерв
synagogue	синагога
representative clothing	одежда
possibly	вероятно
raw	суров
Catholic	католик
tolerance	толерантност
status	статус
instinct	инстинкт
slope	склон
nettle	коприва
giant	гигантски
strongly	силно
style	стил
shepherd	овчар
quietly	тихо
simple	прост
conqueror	завоевател
agony	агония
aggrieved	огорчен
sure	уверен
phooey	аман
town	паланка
reverse	опак
as	както
opilione	сенокосец
lightly	леко
mayor	кмет
съю́з	Съветски съюз
dune	дюна
mafia	мафия
trauma	травма
dimwit	малоумник
colorful	шарен
chill	хлад
dust	прах
vesper bat	нетопир
straight	прав
aphasia	афазия
sister	сестрин
cone	конус
pluck	скубя
oval	овал
lowness	низина
courage	кураж
cricket	щурец
bitterly	огорчено
pleasantness	угода
pleasantly	угодно
impertinently	нагло
criterion	критерий
skull	череп
population	население
circus	цирк
bunker	бункер
work	направа
cross section	сечение
hop	хмел
comber	ханос
sediment	утайка
soft	мек
craft	занаят
rye	ръж
crumb	троха
albeit	макар
educated	образован
around	наоколо
stability	стабилност
instability	нестабилност
learned	учен
crown	теме
readiness	накана
hotel	хотел
measurer	мерач
whistle	свирка
love	обич
greeting	поздрав
appetizer	аперитив
personally	лично
personality	личност
carriage	карета
vermin	гадина
campaigning	агитация
curious	любопитен
cosmopolitan	космополитен
creditor	кредитор
reputation	репутация
restriction	ограничение
contact	контакт
cosine	косинус
clinic	клиника
blizzard	фъртуна
blizzard	виелица
caption	надпис
caption	рубрика
captive	пленник
prisoner	затворник
dead	мъртъв
crew	екипаж
mussel	мида
female animal	самка
criminal	престъпник
tempest	хала
create	създавам
cry	плача
light shirt	срака
octane	октан
toilet	нужник
scale	кантар
biologist	биолог
lattice	решетка
frog	жабар
flamingo	фламинго
mud	глиб
strange	чудноват
distorted	изопачен
dog rose	шипка
raiment	одеяние
banner	стяг
Bulgarian Hound	българско гонче
Bulgarian	гонче
say	казвам
hear	чувам
listen	слушам
ride	езда
damage	щета
detail	детайл
use	използвам
quite noise	шепот
countess	графиня
gnawer	гризач
deviation	девиация
Slav	славянин
bandage	бинт
pulpit	амвон
take	вземам
work	работя
silicon	силиций
shell	раковина
introduction	представление
rough	крут
significance	значение
despotic	деспотичен
photograph	снимка
strong	силен
client	клиент
interaction	взаимодействие
begin	тръгвам
copernicium	коперниций
calmly	спокойно
at last	най-после
say	кажа
female student	студентка
desire	рача
university student	студентски
study	студентствам
student	студентство
also	също
make friends	сприятелявам се
make friends	сприятеля се
cause	сприятелявам
cause	сприятеля
station	гара
interesting	интересен
interest	интересувам
interest	интересувам се
begone	сиктер
put	слагам
smoke	чур
surprise	изненада
holiday resort	курорт
plateau	плато
philologist	филолог
Belarusian	белоруски
Finnish	фински
ceremony	обряд
Icelandic	исландски
Mongolian	монголски
Dutch	холандски
Portuguese	португалски
conglomerate	конгломерат
cardboard	картон
banality	баналност
bandit	бандит
improviser	импровизатор
immunity	имунитет
indirectly	индиректно
individually	индивидуално
infarct	инфаркт
incubator	инкубатор
rash	осип
ozone	озон
choose	избирам
just	коректен
dill	копър
Estonian	естонски
Israeli	израелски
rod	прът
Malta	Малта
help	помощ
help	помагам
parody	пародия
bombard	бомбардирам
cut	режа
shoot	стрелям
contrast	контраст
adornment	накит
lukewarm	млак
milkman	млекар
primary school textbook	читанка
despot	деспот
dose	доза
wide	широко
anathematize	анатемосвам
aerolite	аеролит
security	сигурност
player	играч
debt	дълг
percent	процент
depth	дълбочина
view	изглед
know	зная
European	европеец
female European	европейка
anchor	котва
dinosaur	динозавър
anal	анален
слъ́нчев вя́тър	слънчев вятър
damp	влажен
childhood	детство
among	сред
Gnosticism	гностицизъм
Judaism	юдаизъм
million	милион
breathing	дихание
mania	мания
troglodyte	троглодит
sober	трезвен
cake	торта
vinegar	оцет
fall	падам
Lukashenko	Лукашенко
cockatoo	какаду
in vain	всуе
pneumonia	пневмония
anathematize	анатемосам
skirmish	схватка
kindness	добродушие
kilogram	килограм
ephemerality	ефемерност
eclipse	затъмнение
be	бъда
epilogue	епилог
propaganda	агитационен
dignity	достойнство
capitulation	капитулация
bride	младоженка
given	даден
heterosexuality	хетеросексуалност
bisexuality	бисексуалност
pansexuality	пансексуалност
asexuality	асексуалност
sexual orientation	сексуална ориентация
neighbour	съсед
eating	ядене
hear	чуя
dream	мечтая
search	търсене
adventurously	авантюристично
congratulate	честитя
encounter	срещам
pay	плащам
pay	платя
fall out of love	разлюбвам
fall out of love	разлюбя
bleed	кървя
vote	гласувам
cry	разплача
cry	разплаквам
burst	разплача се
burst	разплаквам се
reread	препрочитам
reread	препрочета
inherit	наследявам
inherit	наследя
create	създам
convince	убеждавам
convince	убедя
satrap	сатрап
savanna	савана
celebrate	чествам
guard	охранявам
sign	подписвам
sign	подпиша
sign	подпиша се
sign	подписвам се
be present	присъствам
be absent	отсъствам
peony	божур
bribe	подкупвам
bribe	подкупя
crown	коронясвам
crown	коронясам
warn	предупреждавам
warn	предупредя
seriously	сериозно
о́чен ле́кар	очни лекарю
о́чен ле́кар	очните лекари
о́чен ле́кар	очни лекари
Slav	славянка
begin	започвам
begin	започна
begin	почвам
large collectivised farm	ТКЗС
proudly	гордо
proud	горд
stupidity	глупост
dish	гозба
mane	грива
toy	играчка
emperor	император
sing	изпявам
sing	изпея
gluttonous	лаком
future	бъдеще
chic	шик
discuss	обсъждам
discuss	обсъдя
blame	виня
accuse	обвинявам
accuse	обвиня
invest	инвестирам
in turn	поред
pass information	съобщавам
pass information	съобщя
taiga	тайга
complexity	комплексност
sheepfold	кошара
failure	неуспех
adhan	езан
Irishman	ирландец
merciful	милостив
devil	дявол
colostrum	коластра
limited	ограничен
airport	летище
weakly	слабо
conveyance	превоз
desolate	пуст
use	ползвам
keep money	пестя
keep money	спестявам
keep money	спестя
captivity	плен
make	подобрявам
make	подобря
become better	подобря се
become better	подобрявам се
Christadelphian	христаделфианец
Christadelphian	христаделфиански
tell	обяснявам
tell	обясня
humble	смирен
look	погледна
take	разхождам
cause	причинявам
cause	причиня
take	разходя
go	разхождам се
go	разходя се
не разби́рам	не разбирам
dine	вечерям
storm	бушувам
lick	ближа
lick	лижа
perish	загивам
perish	загина
by no manner of means	ако ще турско да стане
symbol	символ
sorry	съжалявам
male Swiss	швейцарец
question	въпрос
forbidden	забранен
compound	съставен
friendship	приятелство
explosion	взрив
believe	повярвам
unlock	отключвам
unlock	отключа
dream	сънувам
wake	будя
wake	будя се
sunset	залез
perigee	перигей
colour	боядисвам
colour	боядисам
colour	оцветявам
colour	оцветя
flood	наводнявам
flood	наводня
blackmail	изнудване
arm	въоръжавам
arm	въоръжа
recommend	препоръчвам
recommend	препоръчам
investment	инвестиция
seduce	прелъстявам
seduce	прелъстя
eavesdrop	подслушвам
eavesdrop	подслушам
force	принуждавам
force	принудя
exist	съществувам
hope	надявам се
pharmacology	фармакология
behead	обезглавявам
behead	обезглавя
pronounce	изговарям
pronounce	изговоря
pronounce	произнасям
there is	има
piss	пикая
decide	решавам
drink	изпивам
drink	изпия
choose	избера
save	спасявам
save	спася
swear word	псувня
griffin	грифон
take	взимам
forgive	прощавам
forgive	простя
advise	съветвам
advise	посъветвам
entitle	озаглавявам
entitle	озаглавя
telephone	телефонирам
apogee	апогей
oka	ока
sack	уволнявам
sack	уволня
fine	глобявам
fine	глобя
compare	сравнявам
compare	сравня
hint	намеквам
hint	намекна
defeat	побеждавам
defeat	победя
get	получавам
get	получа
send	пращам
send	пратя
make	разболявам
make	разболея
fall silent	млъквам
abuse	злоупотребявам
abuse	злоупотребя
carry	пренасям
bring	привнасям
bring	принасям
arrival	пристигане
begin	пронасям
travelling	пътуване
carry	разнасям
beat	бия
go mad	полудявам
go mad	полудея
bury	погребвам
predict	предсказвам
predict	предскажа
liquefy	втечнявам
liquefy	втечня
meeting	среща
puzzle	озадачавам
puzzle	озадача
get fat	дебелея
sack	чувал
get fat	надебелявам
get fat	надебелея
hang	беся
hang	обесвам
hang	обеся
legalize	узаконявам
legalize	узаконя
legalize	легализирам
make	ушивам
make	ушия
join	зашивам
join	зашия
wake	събуждам
wake	събудя
approve	одобрявам
approve	одобря
wound	наранявам
wound	нараня
proud	гордея се
need	нуждая се
reproach	упреквам
reproach	упрекна
wish	желая
from where	откъде
bright	светъл
sorcerer	чародей
test	тест
never	никога
operation	операция
exercise	упражнение
opinion	заключение
villain	мерзавец
scoundrel	негодяй
tame	питом
dwarf	джудже
lose	загубвам
distance	разстояние
dozen	дузина
bribe	рушвет
distillation	дестилация
demijohn	дамаджана
hungry	гладен
earn	печеля
burn scar	жиг
sarcasm	сарказъм
resin	клей
drill	бургия
correctly	правилно
swelter	зной
worm	червяк
dislocation	изкълчване
Gibraltar	Гибралтар
president	президент
fine	глоба
archaic	архаичен
string	канап
bounce	подскачане
green woodpecker	желна
tonsillitis	ангина
offence	простъпка
stew	чорба
behind	зад
silt	ил
aftergrass	отава
silk	коприна
watermelon	диня
apologist	апологет
travel	изминавам
travel	измина
sour cherry	вишна
sink	потъвам
sink	потъна
frighten	плаша
suicide	самоубийство
frighten	изплашвам
frighten	изплаша
frighten	уплашвам
frighten	уплаша
threaten	заплашвам
threaten	заплаша
capsule	капсула
inhale	вдишвам
inhale	вдишам
buy	закупувам
buy	закупя
buy up	изкупувам
buy up	изкупя
hear out	изслушвам
hear out	изслушам
melon	пъпеш
adopt	осиновявам
adopt	осиновя
visit	посещавам
visit	посетя
repeat	повтарям
repeat	повторя
visit	навестявам
visit	навестя
write	написвам
write	напиша
experience	преживявам
experience	преживея
break	чупя
break	счупвам
break	счупя
blackmail	изнудвам
blackmail	изнудя
allowed	може
build	построявам
build	построя
combine	съчетавам
combine	съчетая
underline	подчертавам
underline	подчертая
lose	губя
lose	изгубвам
lose	изгубя
lose	загубя
blackmail	шантажирам
combine	комбинирам
embrace	прегръщам
embrace	прегърна
satisfy	удовлетворявам
satisfy	удовлетворя
faint	припадам
faint	припадна
disappear	изчезвам
disappear	изчезна
walk	ходя
kiss	целувам
fungus	гъба
immortalise	обезсмъртявам
immortalise	обезсмъртя
walking	ходене
break	пречупвам
break	пречупя
international	международен
asphalt	асфалт
assassination	атентат
backhoe	багер
banknote	банкнота
sura	сура
great loss	пагуба
prolonged groove	жлеб
sinewy	жилав
complaint	жалба
masturbation	мастурбация
renowned	знаменит
pupil	зеница
closed	затворен
orgy	оргия
archon	архонт
sin	греша
beer	бира
whiskey	уиски
ask	попитвам
ask	попитам
observation	наблюдение
conscience	съвест
seven	седем
eight	осем
stupid	глупав
echolalia	ехолалия
grain	зърно
ionosphere	йоносфера
franc	франк
entire	все
January	януари
June	юни
July	юли
bat	прилеп
Cyprus	Кипър
European Union	Европейски съюз
one	един
dam	яз
Eritrea	Еритрея
frieze	фриз
sodomy	содомия
up	нагоре
naiveness	наивност
element	елемент
boutique	бутик
throat	гърло
да благодаря́	кой
thy	твоя
thy	твои
sheet	блат
corvid	галица
rocky hillock	чука
honorous	честит
flight	полет
antiquarian	антиквар
cent	цент
fluorine	флуор
pelican	пеликан
clearly	явно
accidentally	случайно
thus	така
lodgement	помещение
news	сведение
geographic	географски
coldly	хладно
din	грохот
stork	лелек
plot	сюжет
humus	хумус
platform	платформа
blind	сляп
airplane	аероплан
button	бутон
ratification	ратификация
socialism	социализъм
демократи́чен социали́зъм	демократичен социализъм
English	английски
square	мегдан
limb	уд
и́мам въпро́с	имам въпрос
gain	печалба
minaret	минаре
senator	сенатор
pederasty	педерастия
pederast	педераст
adieu	сбогом
organism	организъм
microorganism	микроорганизъм
straight	направо
armpit	подмишница
to	за да
lest	за да не
bearded	брадат
а	а... а...
sharply	рязко
brain	мозък
do you need help	имаш ли нужда от помощ
do you need help	имате ли нужда от помощ
classification	класификация
as if	като че
as if	като че ли
as if	като да
will	ще
priapism	приапизъм
rat	плъх
tobacco	тютюн
cover	стеля
programme	програма
gauge	мер
nationality	народност
тая бира	ма
playful	щур
auklet	алка
Свеще́н Гра́ал	Свещен Граал
become	ставам
become	стана
but	ама
brightness	яркост
erection	ерекция
croissant	кифла
fundamental interaction	фундаментално взаимодействие
electromagnetic interaction	електромагнитно взаимодействие
gravitational interaction	гравитационно взаимодействие
electromagnetism	електромагнетизъм
weak nuclear interaction	слабо ядрено взаимодействие
strong nuclear interaction	силно ядрено взаимодействие
strong interaction	силно взаимодействие
weak interaction	слабо взаимодействие
nuclear	ядрен
black hole	черна дупка
desert	пустиня
eider	гага
support	поддръжка
God	божи
rim	ръб
Croatian	хърватски
count form	бройна форма
lawyer	адвокатски
gain	кяр
toucan	тукан
book publisher	книгоиздателство
stapler	телбод
sweltering heat	жега
drunk	пиян
news	известие
menu	меню
astatine	астатин
deep	дълбок
слъ́нчев вя́тър	слънчевите ветрове
слъ́нчев вя́тър	слънчеви ветрове
слъ́нчев спли́т	слънчевите сплитове
слъ́нчев спли́т	слънчеви сплитове
Sieg Heil	зиг хайл
pit	трап
locomotive	локомотив
jail	апс
purse	портмоне
senior	старец
kike	чифут
rally	митинг
spindle	вретено
scar	белег
myself	себе си
fresh	свеж
feeding	гой
tortoise	желва
tube	цев
bride-price	вено
pupa	буба
axe	брадва
again	пак
police officer	полицай
perturbation	смущение
wailer	завирушка
learning	обучение
wrestler	борец
abode	обиталище
embodiment	олицетворение
auditor	ревизор
equanimity	равнодушие
enmity	вражда
anorexia	анорексия
nickname	прозвище
there is not	няма
not have	нямам
neuter	нямало
trust	доверие
nice	мил
surprise	почуда
courage	храбрина
tourist	туристка
van	фургон
mushroom	печурка
hall	зала
ravine	овраг
male Slovene	словенец
Macedonian	македонец
Macedonian	македонка
Slovak	словак
Slovak	словачка
Montenegrin	черногорец
Montenegrin	черногорка
mechanic	механик
toast	тост
auto-	авто-
auk	гагарка
female Swiss	швейцарка
ought	бива
meadow	поляна
stand	стоя
limit	ограничавам
limit	огранича
landscape	ландшафт
bye	чао
charnel house	костница
aura	аура
bacon	бекон
selection	отбор
like	подобно
Majesty	величество
разбойнически	разбойник
crowd	навалица
holiday	празник
campus	кампус
pump	помпа
hot	горещ
come	идвам
known	известно
raft	сал
because of	поради
madder	брош
herbage	биле
lime	вар
manganese	манган
python	питон
animal fat	мас
because of	заради
meze	мезе
this	това
this	тоз
this	тогози
this	тогоз
this	тогова
this	томува
this	тая
this	туй
these	тези
these	тия
these	тез
that	оногози
that	оногоз
that	оногова
that	ономува
that	онази
that	оназ
that	оная
that	онова
that	онуй
those	онези
those	ония
such	такъв
sort	онакъв
sort	инакъв
this much	толкова
this much	толкоз
duck	путка
вий	ний
ний	вий
let	нека
lotion	лосион
translator	тълмач
clang	звек
comb	бърдо
your	Ви
bottle	шише
brother	братов
thy	твоят
thy	твоята
thy	твойта
thy	твое
thy	твоето
thy	твойто
thy	твоите
thy	твойте
colorful	пъстър
folks	нашите
folks	наште
folks	вашите
folks	ваште
safety	безопасност
mindlessness	безумност
bandit	бандитски
tunnel	тунел
terrace	тераса
uncommunicativeness	некомуникативност
unproductiveness	непродуктивност
shit	гомно
scabby	шугав
wolverine	росомаха
procession	шествие
woolly	рунтав
playful	игрив
horizontality	хоризонталност
heavens	небеса
again	повторно
сне́жен гло́бус	снежен глобус
claim	иск
Ohio	Охайо
democratic	демократически
cork	плута
fabled character	бага
so	значи
buttocks	задник
newborn	рожба
deer	елен
relative	роднина
parent	родител
moth	молец
tulip	лале
bouquet	китка
lunch	ручек
baked good	печиво
cured sausage	колбас
vegetable	зеленчук
cucumber	краставица
beet	цвекло
pain	болка
gate	порта
reader	читател
cushion	перница
candlestick	светилник
butchershop	месарница
fountain	водоскок
consignment	пратка
goal	цел
groom	младоженец
valor	доблест
talent	дарба
inn	гостилница
magazine	списание
creation	творба
invitation	покана
hill	рид
crag	карпа
hostage	заложник
cough	кашлица
cook	готвач
grater	ренде
loss	загуба
kingdom	кралство
whip	камшик
calculation	сметка
justice	справедливост
threat	закана
mill	мелница
height	височина
allure	прелест
visitor	посетител
moral	поука
hole	дупка
twin	близнак
experiment	експеримент
workshop	работилница
orphan	сирак
furnace	фурна
sour cream	павлака
malefactor	злосторник
firefly	светулка
lamp	фенер
athlete	спортист
joke	шега
hunter	ловец
track	трага
ball	топка
archer	стрелец
worldview	мироглед
bullet	куршум
line	редица
thief	крадец
theft	кражба
free	волен
scary	страшен
double	двоен
enormous	огромен
last	краен
small	ситен
cultural	културен
tasty	вкусен
comfortable	удобен
sour	кисел
personal	личен
peace	мирен
cursed	проклет
decent	пристоен
indecent	непристоен
stable	стабилен
stormy	буен
loving	нежен
liquid	течен
day	дневен
tomorrow	утрешен
yesterday	вчерашен
sole	единствен
original	оригинален
solitary	самотен
naive	наивен
naive	лековерен
righteous	праведен
literal	буквален
funny	смешен
boring	досаден
shameful	срамен
modest	скромен
majestic	величествен
modern	модерен
current	сегашен
ancient	древен
annual	годишен
godless	безбожен
straightforward	прям
sinful	грешен
following	следен
last	последен
underage	малолетен
stupid	малоумен
dark	мрачен
world	световен
happy	весел
strange	чуден
necessary	нужен
necessary	потребен
conditioned	условен
guilty	виновен
strange	особен
empty	празен
unexpected	ненадеен
playful	палав
basic	основен
sufficient	доволен
medium	среден
tired	уморен
juicy	сочен
family	семеен
fleshy	месест
secret	таен
slow	бавен
alphabetical	азбучен
upper	горен
lower	долен
ugly	грозен
revolting	гаден
gooey	лигав
jealousy	ревност
deformed person	изрод
carving	резба
main	главен
clothing	рухо
except	освен
according to	според
majority	мнозинство
together	заедно
so far	досега
now	сега
more or less	горе-долу
down	долу
down	надолу
how big	колкав
tomorrow	утре
today	денес
day before yesterday	завчера
especially	особено
solely	единствено
child	детски
Polish	полски
woolly	влакнест
Ukrainian	украински
American	американски
raincoat	шлифер
hollow	котловина
blacksmith	ковачница
tannery	кожарница
great skua	скуа
whose	чий
despotism	деспотство
hammer	чук
shoe	обувка
snow leopard	барс
embrasure	амбразура
bottle	бутилка
noun	съществително име
wolverine	лакомец
maple	клен
supporter	адепт
magnanimity	великодушие
grandeur	величие
witch	вещица
army commander	воевода
guardsman	гвардеец
guard	гвардия
geographer	географ
sensor	датчик
two	двойка
legion	легион
license	лицензия
model	макет
modification	модификация
quay	мостик
male	особняк
smallpox	оспа
blade	острие
article	очерк
patient	пациентка
periphery	периферия
pianist	пианист
again	повтор
foot	подножие
achievement	постижение
place	преддверие
adequacy	приличие
counterbalance	противовес
notch	разлом
developer	разработчик
subject matter	тематика
tone	тонус
tractor driver	тракторист
ficus	фикус
foreign country	чужбина
camera	фотоапарат
compendium	правилник
nape	тил
fist	юмрук
sine	синус
mountain	балкан
do	правя
timid	плах
antimonium	антимон
newt	тритон
aluminium	алуминий
church	църква
political	политически
statistical	статистически
по́-добре́ къ́сно	по-добре късно, отколкото никога
sleeping	спален
buxom	напета
оздравявай бързо	Оздравявай бързо
national	народен
barren	ледина
tavern	механа
church bell	камбана
blackberry	къпина
Satan	сатана
jasmine	жасмин
well	добре
Aeroflot	Аерофлот
let's	хайде
micro-	микро-
television	телевизия
mute	ням
female spy	шпионка
satire	сатира
Libya	Либия
helium	хелий
beryllium	берилий
Зела́ндия	Нова Зеландия
harm	вреда
coral	корал
strike	стачка
diamond	диамант
bandage	бандаж
arshin	аршин
adjective	прилагателно име
mode	лад
receive	приема
sow	сея
kaval	кавал
caracal	каракал
common	общ
rust	ръжда
angle	ъгъл
building	сграда
happiness	щастие
contemporary	съвременен
Swiss	швейцарски
зве́зден вя́тър	звезден вятър
зве́зден дъ́жд	звезден дъжд
Earth	Земя
ginger	риж
atom	атомен
atomic bomb	атомна бомба
examine	изпитвам
examine	изпитам
peasant	селянин
Hagarene	агарянин
ibis	ибис
sandpiper	бекас
thrust	тикам
Arctium lappa	репей
calorie	калория
violin	цигулка
brilliance	блясък
usually	обикновено
Fury	фурия
threshing floor	гумно
old man's beard	павет
apricot	кайсия
cape	пелерина
magnesium	магнезий
rug	килим
two hundred	двеста
four hundred	четиристотин
five hundred	петстотин
six hundred	шестстотин
seven hundred	седемстотин
eight hundred	осемстотин
nine hundred	деветстотин
kilo-	кило-
smoke	пуша
parasitic worm	глист
jug	стомна
pistachio	фъстък
cage	кафез
kindness	добрина
puppy	кученце
abortive	абортивен
dolma	сарма
oilskin	мушама
defender	бранител
great-grandmother	прабаба
brooding hen	квачка
butcher	касап
mistress	стопанка
stretch	провлак
collared dove	гугутка
millionaire	милионер
tap	чешма
bookshop	книжарница
envelope	плик
homework	домашна
homework	домашна работа
piece	мебел
adze	тесла
even	равен
known	известен
large	крупен
necessary	необходим
separate	отделен
strange	странен
special	специален
science	научен
free	свободен
dear	любим
dear	любима
constant	постоянен
official	официален
literary	литературен
calm	спокоен
dry	сух
difficult	труден
powerful	мощен
traditional	традиционен
pleasant	приятен
characteristic	характерен
visible	виден
honest	честен
cut	резка
unknown	неизвестен
worthy	достоен
stone	каменен
valuable	ценен
accidental	случаен
minimal	минимален
ancient	старинен
obvious	очевиден
legal	законен
maximal	максимален
nervous	нервен
preliminary	предварителен
grievous	печален
ideal	идеален
honourable	уважаем
public	публичен
fashion	моден
open	явен
pale	бледен
developed	развит
opposite	противен
flat pitcher	плоска
illegal	незаконен
absurd	нелеп
crazy	безумен
sudden	внезапен
boring	скучен
foreign	чужд
significant	значим
noisy	шумен
vague	неясен
sober	трезв
bossy	властен
similar	сходен
banal	банален
fractional	дробен
lazy	ленив
amiable	любезен
united	дружен
polite	вежлив
poor	нищ
furious	яростен
abundant	обилен
single	единичен
rotten	гнил
truthful	правдив
obscene	скверен
sweaty	потен
smooth	плавен
stuffy	душен
oval	овален
superficial	мним
hot	лют
credulous	доверчив
company	дружествен
distinguished	знатен
legal	легален
vulnerable	уязвим
temporary	временен
fit	годен
antique	антикварен
impertinent	нахален
authoritarian	авторитарен
sultry	зноен
amorphous	аморфен
legitimate	легитимен
lame	куц
picnic	теферич
nickel	никел
slaughterhouse	кланица
celebration	веселба
work abroad	гурбет
downfall	падина
cook	готвачка
cry	вик
biter	сечко
in turn	подред
director	директорка
tan	тен
echo	ек
praying mantis	богомолка
membrane	лил
event	собитие
match	кибрит
printing factory	печатница
female reader	читателка
banitsa	баница
knight	рицар
patty	плескавица
piece	парченце
agreement	спогодба
certificate	свидетелство
raptor	грабливец
qalat	кале
beacon	фар
migrant	преселник
gratitude	благодарност
repeatable	повторяем
hand	подам
available	изучаем
curable	лечим
honourable	почитаем
hand in	предам
land vermin	жуй
bypassable	обходим
worth distinguishing	отличим
differentiable	различим
fell	поли
winner	носител
motto	лозинка
stupid woman	глупачка
blade	ноже
greenish	зеленикав
baby	бебешки
sweet	миловиден
individual	едноличен
one-eyed	едноок
anarchic	анархичен
fixed	определен
center	централен
non-alcoholic	безалкохолен
alcoholic	алкохолен
horned	рогат
unworthy	недостоен
scabby	крастав
pack	глутница
angel	ангелски
local	местен
real	конкретен
transport	превозен
neutral	неутрален
clumsy	тромав
sterile	стерилен
pious	набожен
aggregate	агрегатен
advertising	рекламен
loud	гръмък
mongrel	помияр
let's	аре
know	знам
wheeze	хрип
splasher	плескало
big ears	ушат
world	миров
layer	сил
wind	духов
track	следа
cloth	плат
logician	логик
furniture	мебели
stade	стадий
statistician	статистик
claim	исков
people	хора
thick smoke	пушек
bronze	туч
horn	рогов
real estate	недвижимости
mint	мента
honey	медов
hearth	камина
thallium	талий
varnish	лаков
bark	лая
number	чет
tent	шатра
rubbish	смет
wild hen	курка
carob pod	рожков
insist	настоя
hawk	ястребов
battle	боен
quarantine	карантина
plum	сливов
collar	яка
giaour	гяур
much	бая
pot	крина
pour	лея
uneducated	невеж
Norwegian	норвежки
shear	стрижа
feel	чувствам
leaves	листе
want	поискам
let go	отпускам
kitten	коте
sought	иском
slap	шляпам
bunch	тесте
goatling	козле
chicken	петле
jack	вале
salami	салам
let	пускам
chief master	ватах
massacre	клане
calf	биче
slap	пляскам
begin	заставам
again	повтором
slap	шлакам
vineyard	лозе
lamb	шиле
jacket	яке
scream	викам
devour	зобам
mule	муле
throw	мятам
duckling	пате
усое	сое
dad	тате
candlestick	свещник
trustfulness	доверчивост
Arabic	арабски
devilish	дяволски
satanic	сатанински
satanic	сатанистичен
beastly	зверски
egg-shaped	яйцевиден
apple	ябълков
Adam's apple	Адамова ябълка
Japanese	японски
amateur	любителски
curious	любознателен
Australian	австралийски
Austrian	австрийски
automatic	автоматичен
Asian	азиатски
anatomical	анатомичен
astronomical	астрономически
atmospheric	атмосферен
anthropological	антропологичен
via	чрез
bacterial	бактериален
infantile	инфантилен
child	детински
moneyless	безпаричен
poor	бедняшки
scanty	оскъден
insufficient	недостатъчен
unhappy	нещастен
sad	тъжен
incredulous	невярващ
unscrupulous	безскрупулен
merciless	безмилостен
scops owl	чухал
divide	деля
large mortar	дибек
atheism	атеизъм
tautology	тавтология
improvement	мелиорация
copper	бакър
definition	дефиниция
autoclave	автоклав
restaurant	ресторант
economy	икономика
wedding	сватба
employer	работодател
clunker	трошка
calf	телешки
cliff	спила
technical	технически
linguistics	езикознание
Ethiopia	Етиопия
etymology	етимология
respectfully	чинно
strategic	стратегически
chronicler	летописец
ба́за да́нни	база данни
proto-language	праезик
педаго́гика	специална педагогика
woodlouse	мокрица
chief	началник
lazybones	ленивец
snowdrop	кокиче
scaffolding	скеле
honey extract	медовина
duck	шатка
wooden rod	токмак
woodpecker	детел
wormwood	пелин
sweetheart	либе
sane	вменяем
inflatable	надуваем
clothing	облекло
gentle whiff	повей
irritable	раздразним
tansy	вратика
stamp	тропот
speaker	говорител
wedge	ижица
remember	помня
can	умея
serve	служа
set	ставя
mean	знача
carry	нося
belong	принадлежа
entertain	занимая
hang	вися
possess	владея
feed	храня
conduct	водя
chase	гоня
bulged	пугав
create	творя
contradictory	противоречив
clean	чистя
predict	предвидя
read	глася
melt	топя
heat	грея
slaughter	коля
stick	лепя
fleck	шаря
make	чиня
flattering	ласкав
blow	вея
measure	меря
tailor	кроя
mill	меля
impressive	величав
worship	боготворя
keen	бдя
vomit	блюя
bleat	блея
shield	браня
rotten	гранив
do	дея
temper	каля
heed	кутя
knead	меся
point	соча
outside	вонка
low hill	баир
diver	нурец
Taiwan	Тайван
raven	гарван
theatre	театър
dispatch	депеша
wheel	колело
gala	гала
dress	рокля
breathe	дишам
warmth	топлик
princess	принцеса
atomic bomb	ядрена бомба
Irish	ирландски
division	дележ
brochure	брошура
thousand	хиляда
butt	фас
atrophy	атрофия
iodoform	йодоформ
collation	сверка
old man's beard	павит
Ара́бия	Саудитска Арабия
fortress	крепост
I'm an atheist	аз съм атеист
kiss	целувка
father-in-law	свекър
really	наистина
surprise	нима
северноамерика́нски мармо́т	северноамерикански мармот
recover	ближа си раните
fortified structure	хисар
property	стопанство
excited	възбуден
calloused	мазолест
wallet	портфейл
lofty	надутост
racism	расизъм
there's no accounting for taste	разни хора-разни вкусове
carbon	въглерод
sulphur	сяра
calcium	калций
cobalt	кобалт
gallium	галий
once upon a time	имало едно време
philately	филателия
fence	плет
whither	накъде
use	полза
female hooligan	хулиганка
yttrium	итрий
palladium	паладий
tellurium	телур
dysprosium	диспросий
holmium	холмий
erbium	ербий
ytterbium	итербий
lutetium	лутеций
hafnium	хафний
tungsten	волфрам
lively	живак
bismuth	бисмут
astatine	астатий
einsteinium	айнщайний
rutherfordium	ръдърфордий
hassium	хасий
darmstadtium	дармщатий
roentgenium	рьонтгений
nihonium	нихоний
flerovium	флеровий
moscovium	московий
livermorium	ливерморий
tennessine	тенесин
oganesson	оганесон
atony	атония
bran	трици
update	актуализирам
write down	записвам
update	актуализация
male	стилист
subject	подлог
contusion	контузия
fog	мъгла
female employer	работодателка
hand	ръчен
like	харесвам
like	харесам
likeable	обичлив
wipe	изтривам
put	настанявам
switch on	включвам
shut down	изключвам
deactivate	деактивирам
activate	активирам
jasmine	жасминов
pair	панталон
broadcloth	чоха
kid	яре
tune	грай
World War I	Първа световна война
World War II	Втора световна война
soldier	войник
be at war	воювам
war	военен
Vietnam War	Виетнамска война
Korean War	Корейска война
reliance	упование
cowardice	малодушие
action	-ие
bonus	бонус
storm	буревестник
firebird	жар-птица
wedding	венчален
Ganymede	Ганимед
Callisto	Калисто
Io	Йо
Titan	Титан
Triton	Тритон
Phobos	Фобос
Deimos	Деймос
Rhea	Рея
Iapetus	Япет
Dione	Диона
Tethys	Тетида
Enceladus	Енцелад
Mimas	Мимас
Titania	Титания
Oberon	Оберон
Umbriel	Умбриел
Ariel	Ариел
Miranda	Миранда
Charon	Харон
Hydra	Хидра
Kerberos	Цербер
Styx	Стикс
plumber	водопроводчик
Hiʻiaka	Хияка
Namaka	Намака
Dysnomia	Дисномия
Ceres	Церера
Eris	Ерида
Haumea	Хаумея
Makemake	Макемаке
perfume	парфюм
account	разказ
nap	дрямка
clan symbol	тамга
Slavic	славянски
fortune	късмет
today	днеска
gadget	джаджа
bustard	дропла
sketchbook	скицник
master	стопанин
caddis fly	ручейник
Aleister	Алистър
iamb	ямб
apologia	апология
chronic	хроничен
modal	модален
textile	текстилен
muddy	илест
freckled	пегав
musical	музикален
sonorous	звучен
labile	лабилен
professional	професионален
instinctive	инстинктивен
work	работен
elementary	елементарен
gravitation	гравитационен
administrative	административен
instantaneous	моментален
webbed	мрежест
prospective	евентуален
esoteric	езотеричен
intellectual	интелектуален
regional	регионален
lethal	гибелен
awkward	смотан
indefinite	неопределен
national	национален
VAT	ДДС
bargain	далавера
hectic	трескав
survey	анкетен
wheat	житен
exhausting	тегав
used	тупав
nearby	околен
pokey	туткав
credit	кредитен
lactation	лактационен
coast	брегови
exactness	определеност
pop	пукот
stepson	пасинок
detail	подробност
freeloader	готован
limescale	бигор
cassette player	касетофон
saliva	слюнка
домашар	домашар
wave	махам
plummet	отвес
drag	влача
deadly disease	морило
give birth	родя
winner	победител
exclusion	изключване
raincoat	дъждобран
lend	заема
hairdryer	сешоар
sheet metal	ламаринен
climatology	климатология
pretty	гиздав
gaff	канджа
some	някой
pin	чивия
Wikipedia	Уикипедия
flowerpot	саксия
tripe	шкембе
appellate	апелационен
little brother	братче
flashlight	фенерче
piglet	гуде
frivolity	лекомисленост
narrow-mindedness	ограниченост
worker	работничка
hepatitis	хепатит
swallow	гълтам
descriptivity	дескриптивност
destructiveness	деструктивност
depressiveness	депресивност
explosivity	експлозивност
expressivity	експресивност
effectiveness	ефективност
impulsiveness	импулсивност
interactiveness	интерактивност
intuitiveness	интуитивност
collectiveness	колективност
communicativeness	комуникативност
manipulativeness	манипулативност
gullibleness	лековерност
inactivity	неактивност
normativity	нормативност
provocativeness	провокативност
progressiveness	прогресивност
retrospectiveness	ретроспективност
selectiveness	селективност
speculativeness	спекулативност
conditionality	условност
fictitiousness	фиктивност
poverty	бедност
invalidity	невалидност
wonderfulness	прекрасност
perfidy	перфидност
righteousness	праведност
momentary	моментен
grotesqueness	гротескност
perfidy	вероломност
extremeness	екстремност
legitimacy	легитимност
illegitimacy	нелегитимност
uniformity	еднообразност
regularity	закономерност
complementarity	комплементарност
legendariness	легендарност
militancy	воинственост
controversiality	спорност
interestingness	интересност
corporeality	телесност
lability	лабилност
abundance	обилност
mediopassive	медиопасивен
correlate	корелат
proclitic	проклитичен
deponent	депонентен
indicative	индикативен
causative	каузативен
unmarked	немаркиран
perfective	перфективен
imperfective	имперфективен
suppletive	суплетивен
rotational	ротационен
adaptational	адаптационен
acclimatizational	аклиматизационен
articulatory	артикулационен
vibrational	вибрационен
distillatory	дестилационен
evacuation	евакуационен
expedition	експедиционен
identificatory	идентификационен
isolational	изолационен
incubational	инкубационен
installation	инсталационен
integration	интеграционен
classificatory	класификационен
concentration	концентрационен
coordinational	координационен
culmination	кулминационен
mobilisation	мобилизационен
occupation	окупационен
operation	операционен
opposition	опозиционен
organisational	организационен
orientational	ориентационен
oscillation	осцилационен
projection	проекционен
ratification	ратификационен
reactional	реакционен
registrational	регистрационен
regulational	регулационен
editorial	редакционен
recreational	рекреационен
rehearsal	репетиционен
reproductional	репродукционен
rehabilitative	рехабилитационен
selectional	селекционен
dubbing	синхронизационен
sterilisation	стерилизационен
circulatory	циркулационен
fermentation	ферментационен
anaphoric	анафоричен
pigmentary	пигментен
hydroelectric	хидроелектричен
paper	книжен
enclitic	енклитичен
blinding	заслепителен
undiluted	неразреден
rose	трендафил
endemic	ендемичен
conjunction	хем
sheath	ножница
position	поставеност
whey	суроватка
mould	плесен
breed	въдя
little bustard	стрепет
quencher	поилка
late	късен
mint liquor	ментовка
rhea	нанду
bandit	харамия
great-grandfather	прадядо
Proto-Slavic	праславянски
eyebrow	вежда
bandit	арамия
heal	видая
want	сакам
milli-	мили-
rock climber	скалолазка
hecto-	хекто-
cunning	хитър
cold	хладен
sharp	остър
ray	лъч
joule	джаул
музика́лен инструме́нт	музикален инструмент
guitar	китара
polygamy	полигамия
demigod	полубог
pierce carefully	бадакам
crimson	багър
flannel	фланела
water polo	водна топка
prevail	делея
grow	раста
Snow Maiden	Снежанка
unaggressive	неагресивен
premiere	премиерен
but	ами
houri	хурия
penknife	чекия
nap	дремя
infant	пеленаче
real estate	недвижимост
gullible person	лековерник
credulity	лековерие
authorization	овластителен
valerian plant	дилянка
squadron	ескадрила
epistemology	епистемология
wrestle	боря
kind	тимар
saddle	седловина
gunstick	шомпол
anonymous	безименен
rat	паткан
threshing sledge	диканя
myrtle	мирта
fervor	пек
spine	гръбнак
inula	оман
pseudoscience	псевдонаука
dendrochronology	дендрохронология
pseudoscience	лъженаука
Darwinism	дарвинизъм
cypress	селвия
strike	чукам
Antiochene	антиохийски
beetroot	панджар
fan	ветрило
poison hemlock	мангуна
petition	харзувал
iron	ютия
pull	дърпам
loaf	самун
bomb	кумбара
giddy up	дий
path	пътека
parsnip	пащърнак
rag	дрипа
cart	дрика
coltsfoot	подбел
thick forest	дрибак
thicket	шубрак
thick forest	гъстак
direction	посока
reach	дизя
proboscis	дизица
tie	стага
Montpellier maple	маклен
bunch	шумак
however	обаче
duck	биба
beep	бибикам
poke	бицам
staff	тояга
hearth	ватог
pot	кърчаг
pointy tip	бодил
ramson	левурда
pierce	пробождам
that is	демек
bark	гавкам
sparrowhawk	кобец
ditch	копаница
blue	модър
dark brown	смядов
black-eyed	вакъл
ash	сяр
brown	кафяв
beige	бежов
grayish brown	бозав
light	брязък
yellowish green	резедав
magenta	цикламен
clear	лазурен
fondle	галя
sceptre	жезъл
branding needle	жегъл
chew	преживям
melt	копнея
white oak	стеж
oak	дъб
footle	щурея
cabbage	зеле
bitter substance	горчивка
mullein	лопен
rainfall	валеж
feisty	бояк
yearling	годинак
sheaf	въдък
herd	черда
heal	избъдвам
voluntary work	тлака
mullein	дивизма
vomit	бълвам
be stingy about	свидя се
visit	свиждам
witness	свидетел
loose	хлабав
drawer	чекмедже
torment	мъча
box	чимшир
pillar	стълб
post	стълп
ladder	стълба
stairs	стълбище
trample	траща
spruce	смърч
cleanse	цестя
suffer	търпя
Syrian man	сириец
Syrian woman	сирийка
crumb	криха
crush	троша
pop	пуцам
charcoal	въглен
ember	кюмюр
ди́в ко́пър	див копър
fennel	резене
possessor	-лия
Varna	варналия
Burgas	бургазлия
Haskovo	хасковлия
Edirne	одринлия
Dobrich	добричлия
Ruse	русенлия
Strandzha	странджалия
Македо́ния	Северна Македония
abort	абортирам
sourly	кисело
fermented milk	кисело мляко
several	няколко
spark	дзръцка
dogwood	свид
cornel tree	дрян
tear	сълза
же́нски род	женски род
respiration	дишане
inhale	дихам
мъ́жки род	мъжки род
March	мартеница
Lithuanian	литовски
Turkism	турцизъм
former	тогавашен
male	мъжки
then	тогава
former	предишен
once	някога
erstwhile	някогашен
long past	отдавнашен
long ago	отдавна
long ago	недавна
recent	недавнашен
recent	скорошен
today	днешен
tear	дера
mount	яхам
poured	лят
whirlpool	въртоп
turn	врът
pond	върпина
turn	въртя
turn	вратя
return	връщам
bag	врещ
overcoat	вретище
hectare	вретен
growling	дръча
pull	дърцам
pull	дързам
crumble	дъргам
shake	дръгна
hold	държа
handle	дръжка
haft	държало
rakija	ракия
wizard	вещер
great martyr	великомъченик
great martyress	великомъченица
protomartyr	първомъченик
protomartyress	първомъченица
stock	шибой
pit	вагаш
hollow	валог
bundle	вързоп
rinse	плакна
refer	упова
refer	уповавам
фъстъ́к	шам-фъстък
filling	натоварване
guard	пастря
muddy	тинест
mire	тиня
guard	пазя
guard	пазач
protector	пазител
shield	вардя
shield	защитавам
shield	защитя
scab	струпей
congeal	стрепя
graze	охлузване
sprain	навяхване
rubbing	ожулване
bruise	натъртване
swelling	цицина
burning	изгаряне
put	гуждам
artichoke	гута
play	гъдя
play music	гъдувам
conduct	жрея
fleece	хлъпка
disease	заболяване
discomfort	разстройство
epidemic	епидемия
pandemic	пандемия
allergy	алергия
secularism	секуларизъм
sickness	легоба
pray	дебя
pervade	дябам
strike	депвам
stomp	тепам
patch	тесам
steal	гепя
union	съюз
-able	-им
-able	-аем
-able	-ваем
sacrificial	всежегом
-able	-уем
suckle	кърмя
coronavirus	коронавирус
swelling	подутина
graze	драскотина
blueness	синина
Zara	Зара
зва́телен паде́ж	звателен падеж
Russian	руснак
Russian	рускиня
syllable	сричка
Bulgarian	българка
гора́	Черна гора
always	винаги
always	всякога
Serb	сърбин
Serb	сръбкиня
how much	колко
café	кафене
right	нали
nothing	нищо
nobody	никой
however	пък
health	здраве
garment	дреха
clothing	дрехи
stop	спирка
advice	съвет
air conditioning	климатик
mail	поща
answer	отговор
yet	още
quarter	четвърт
traffic light	светофар
Czech	чехкиня
Polish	полякиня
fever	висока температура
shaking	втрисане
fever	тресом
epidemic	мъжда
glimmer	мъждя
zoonosis	зооноз
beat	тупам
swatter	тупалка
Greek	гръцки
whiff	лъх
engine	двигател
idiot	тъпак
judge	съдия
circle	кръг
piano	пиано
nose	носле
leaf	листо
hairdresser	фризьор
rich man	чорбаджия
daughter	щерка
past	минало
present	настояще
jewel	бижу
meeting	събрание
suitcase	куфар
waiter	сервитьор
towel	кърпа
hello	здравейте
турцизъм	-изъм
vertigo	световъртеж
fatigue	отпадналост
exhaustion	изтощение
shortness of breath	задух
tinnitus	шум в ушите
itch	сърбеж
Slovak	словашки
French	френски
Frenchman	французин
French	французойка
Chinese	китайка
Chinese	китайски
corner	кът
definite article	членувам
bride	невяста
adolescent girl	девойка
remind	спомням
billy goat	пръч
attaché	аташе
copper pot	медник
gift	подарък
heir	потомък
slacker	мързелан
wise man	мъдрец
part	дял
stupid woman	тъпачка
value	стойност
whole	цялост
spot	петънце
exception	изключение
supplement	допълнение
Hungarian	унгарец
Hungarian	унгарка
firewood	дърва
drunkard	пияница
fields	нивя
disability	недъг
inborn weakness	жуда
lack sleep	жудя
immediately	веднага
flesh	плът
intestine	черво
low	подъл
jaw	челюст
navel	пъп
running	тичешком
note	бележка
fireplace	огнище
barrel	бъчва
towards	към
morning	сутрин
break	междучасие
vaccine	ваксина
sickle	сърп
retrovirus	ретровирус
gaunt	мършав
swear	псувам
swim	плувам
harvest	жътва
slut	уличница
caterpillar	гъсеница
dew	росица
small forest	горица
nickname	прякор
Sofian	софиянец
Sofian	софиянка
Sofian	софийски
user	потребител
lucky person	късметлия
mailman	пощальон
mailman	пощаджия
traffic police officer	катаджия
natural	естествен
Azerbaijani	азербайджански
Belgian	белгийски
Montenegrin	черногорски
Bosnian	босненски
Latvian	латвийски
Danish	датски
Georgian	грузински
Korean	корейски
Belarusian	беларуски
Persian	персийски
vocative	звателен
brand	дамга
пъ́лен член	пълен член
непъ́лен член	непълен член
generous	щедър
bottlenose dolphin	афала
placeholder	Горно Нанадолнище
panpsychism	панпсихизъм
soldering	спойка
slivovitz	сливова
shopska salad	шопска
Shopluk	шопски
despotess	деспотица
hotel	странноприемница
Romanian	румънски
myroblyte	мироточив
Alps	Алпи
concrete	бетонен
wood	дървен
low	низък
business	делови
scale	везни
hearth	жерава
earthquake	земетръс
despotism	деспотизъм
crane	жеравен
crane	жеравов
mistress	владичица
Islam	ислям
Muslim	мохамеданин
Muslim	мюсюлманин
Muslim	мохамедански
Muslim	мюсюлмански
Christian	християнски
Christian	християнин
low	нисък
same	същ
Indian	индийски
difficult	мъчен
same	еднакъв
next	следващ
future	бъдещ
state	държавен
actual	настоящ
own	собствен
at least	поне
two	двама
each	всеки
all	всички
everything	всичко
considerable	немалък
accident	злополука
grown-up	възрастен
again	отново
eggplant	патладжан
article	членуван
flame	пламък
plate	чиния
pot	гърне
crane	турна
flint	кремък
deacon	дякон
deacon	дяконски
ring	звънлив
ring	звънък
ring	звън
bricklayer	зидарски
egg	яйчен
spherical	ябълковиден
horse rider	ездач
female horse rider	ездачка
carbon	въглероден
lamb	агнешки
lamb	агнешко
big	едър
Adriatic	адриатически
rope	въжен
tongue	езичен
language	езиков
male linguist	езиковед
female linguist	езиковедка
linguistic	езиковедски
paganism	езичество
pagan	езически
gnarled	възлест
iambic	ямбичен
January	януарски
kid	ярешки
husband	етърва
husband	етървин
barley	ечемичен
ion	йон
ion	йонен
duvet	юрган
bow	лък
bow	лъков
cradle	люлка
lilac	люляк
lilac	люляков
Yugoslavian	югославски
July	юлски
heroic	юначен
heifer	юница
calf	прасец
June	юнски
fan	любител
female fan	любителка
love	любовен
womanizer	любовчия
tramp	любовчийка
open	открит
arms	обятия
pocket	джоб
gentleman	джентълмен
gentleman	джентълменски
jazz	джазов
judo	джудо
bright	ярък
dishonest	безчестен
free	безплатен
repulsive	гнусен
unsuitable	негоден
bitter	горък
thick	гъст
dirty	мръсен
indebted	длъжен
strong	крепък
round	кръгъл
wet	мокър
muddy	мътен
bad	недобър
incomplete	непълен
direct	пряк
uneven	неравен
loose	рохък
thin	рядък
sharp	рязък
fat	тлъст
wife	тъст
brisk	чевръст
nearby	недалечен
worn out	вехт
smooth	гладък
long time	дълго
wretched	жалък
torrid	жарък
gentle	кротък
laziness	мързел
lazy	мързелив
power	мощ
power	мощност
infirmity	немощ
infirm	немощен
infirmity	немощност
powerful	могъщ
insolent	нагъл
wrong	неправ
undeveloped	неразвит
private	частен
ownership	собственост
trite	пошъл
immaculate	пречист
immortal	безсмъртен
rubbish	боклук
Jewish	еврейски
economy	икономически
baker	хлебарка
baker	хлебар
married	женен
married	омъжен
strap	ремък
yoke	ярем
bag	мях
solecism	свръхякане
extra-	свръх-
сре́ден род	среден род
because	защото
тъй като́	тъй като
thus	тъй
few	малко
too	твърде
more	повече
fat	тлъстина
fat	лой
spray	стрък
inside	вътрешност
entrails	вътрешности
wash	мия
excuse me	извинете
-ish	-ичък
slavery	робство
hill	хълм
line	щрих
hillock	тепе
hill	рът
subject matter	тематичен
darkness	тъма
dark	тъмен
dungeon	тъмница
hops	хмелен
hub	хъб
greyhound	хрътка
crunchy	хрупкав
ruler	властник
dominant	властнически
hot-tempered	гневлив
numeral	числителен
numeral	числително
uniqueness	единичност
one	едничък
finely	дребно
change	дребни
narrow-minded	дребнав
grain	зърнен
fashion designer	моделиер
conceited	нескромен
flat	плосък
inside	вътре
inner	вътрешен
outside	вън
outer	външен
diplomatic	политичен
semicircular	полукръгъл
that is	сиреч
Syrian	сирийски
statistical	статистичен
posture	стоеж
patient	търпелив
patiently	търпеливо
patience	търпеливост
puny	хилав
hoarse	хриплив
value	ценност
respectful	чинен
loneliness	самота
alone	самичък
male animal	мъжкар
first	пръв
usual	обичаен
meaning	смисъл
double	двояк
crowd	бутаница
ambiguous	двусмислен
ambiguity	двусмисленост
ambiguity	двусмислие
ambiguity	двусмислица
meaningless	безсмислен
dual	двойствен
two-faced	двуличен
binary	двоичен
exit	изход
exit	изходен
basically	основно
male	основател
valid	основателен
reasonably	основателно
validity	основателност
steep	стръмен
death	смъртен
dead man	смъртник
dead woman	смъртница
hunchbacked	гърбав
technical	техничен
economist	икономист
female economist	икономистка
economical	икономичен
paradise	райски
style	стилов
stylish	стилен
stylistic	стилистичен
female hairstylist	стилистка
skill	похват
skillful	похватен
furnish	мебелировка
bloody	кървав
blood sausage	кървавица
physical	физичен
strategic	стратегичен
routine	рутинен
link	връзка
planning	планиране
management	управленски
manager	управителен
order	управия
wizard	баяч
witch	баячка
Catholic	католически
Catholic woman	католичка
Catholicism	католицизъм
peaceful	миролюбив
inventory	вещеви
explosive	взривен
property	вещен
just	тъкмо
inclined	склонен
inclination	склонност
mother	матерен
bird	птичи
large	големичък
small	мъничък
scale	мащаб
gigantic	великански
grandeur	величавост
artificial	изкуствен
architectural	архитектурен
biographical	биографичен
primary	първичен
silk	копринен
perverse	извратен
district	окръг
district	окръжен
restrictive	ограничителен
place	местност
appropriate	съответен
definitely	определено
definite	определителен
bathroom	тоалетна
significance	значимост
court	съдебен
social	обществен
social	социален
information	информационен
embassy	посолство
wetland	тресавище
oil	нефт
oil	олио
rest	почивка
rest	отдих
meadow	лъка
atelier	ателие
sometimes	понякога
license	лиценз
original	първоначален
initial	начален
additional	допълнителен
situated	разположен
location	разположение
distribution	разпределение
executive	изпълнителен
commission	комисионен
medicine	лекарствен
foreign	чуждестранен
transport	транспортен
processed	обработен
electronic	електронен
building	строителен
birth	рожден
program	програмен
usual	обикновен
appeals	касационен
cassation	касация
investment	инвестиционен
consecutive	пореден
tax	данъчен
tax	данък
accounting	счетоводен
clinical	клиничен
specific	специфичен
supreme	върховен
on	върху
insurance	осигуровка
health	здравен
industrial	промишлен
food	хранителен
who	който
think	мисля
sir	сър
quickly	бързо
sufficient	достатъчен
sufficiently	достатъчно
human	човешки
pleasure	удоволствие
creature	същество
faithfully	вярно
doubt	съмнение
pain	мъка
floor	етаж
while	докато
even	дори
not even	нито
completely	съвсем
where	където
seldom	рядко
out	навън
in spite of	въпреки
against	срещу
float	плюто
crosswise	пряко
as if	сякаш
some	някакъв
move	движа
as soon as	щом
necessary	трябвам
smile	усмихвам се
heavily	тежко
outside	извън
trial	изпитание
license	лиценция
Easter	Великден
no	никакъв
there	ето
heartless	безсърдечен
come	дойда
go	отивам
go	отида
resurrect	възкресявам
resurrect	възкреся
raise	възкръсна
resurge	възкръсвам
interjection	междуметие
Soviet	съветски
Saudi	саудитски
tremble	треперя
gape	зея
go	ида
bathe	къпя
roar	рева
look at	гледам
beautifully	хубаво
throw	хвърлям
actually	всъщност
Black Sea	Черно море
male Jew	евреин
liar	лъжец
leader	ръководител
bakery	хлебарница
baptism	кръщение
beggar	просяк
barber	бръснар
eating	хранене
announcement	обява
cost	струвам
smile	усмихвам
smoking	пушене
distress	огорча
taste bitter	горча
bitter	горчив
bitter substance	горчилка
smile	усмивка
passenger	пътник
disgrace	безчестя
give birth	раждам
birth	раждане
be born	раждам се
be born	родя се
basement	мазе
smell	мириша
smell	миризма
entrepreneur	предприемач
martyr	мъченик
necessary	трябва
suggest	предложа
free	безплатно
curse	кълна
utterance	изказване
unwanted	нежелан
sweetness	сладост
mark	бележа
rely	упова се
aware	вям
love	обожавам
identity	самоличност
capture	превзема
stay	остана
do	направя
do	направям
return	върна
find	намеря
maybe	невям
awake	ведувам
stump	пън
awake	будувам
turn	обърна
turn	обръщам
leave	оставя
leave	оставям
grasshopper	скакалец
jump	скачам
as much as	колкото
as far as	доколкото
than	отколкото
fully	пълно
fully	напълно
slowly	бавно
generally	изобщо
temper	калявам
overdo	прекаля
overdo	прекалявам
exaggerated	прекален
too	прекалено
where	дето
deeply	дълбоко
carefully	внимателно
nearby	близо
easily	лесно
probably	навярно
name	именен
as much as possible	възможно
naturally	естествено
beat	удрям
beat	ударя
terrified manner	ужасено
terrify	ужася
terrify	ужасявам
tear	късам
interrupt	прекъсна
interrupt	прекъсвам
continuous	непрекъснат
continuously	непрекъснато
state	състояние
answer	отвърна
answer	отвръщам
answer	отговоря
answer	отговарям
watch	изглеждам
watch	изгледам
lift	вдигна
lift	вдигам
think over	помисля
think over	помислям
irade	ираде
foyer	фоайе
tarragon	тарос
worth	струва
notice	забележа
notice	забелязвам
catch up with	стигна
catch up with	стигам
keep	крия
discover	открия
discover	откривам
shout	извикам
shout	извиквам
therefore	затова
throw	метна
compute	смятам
compute	сметна
find	намирам
smile	усмихна
smile	усмихна се
know	познавам
throw	хвърля
nod	кимна
nod	кимвам
try	опитвам
try	опитам
take out	вадя
tell	обадя
tell	обаждам
make	накарам
make	накарвам
hold	хвана
hold	хващам
speed	бързина
threat	заплаха
keyhole	ключалка
hindsight	мерник
cross	кръст
seem	изглежда
time	успея
time	успявам
mister	мистър
observe	наблюдавам
responsibility	отговорност
fairy tale	приказка
put	дяна
put	поставям
put	поставя
put	сложа
show	покажа
show	показвам
set upright	изправя
set upright	изправям
learn	науча
learn	научавам
finish	свърша
finish	свършвам
take out	извадя
take out	изваждам
send	изпратя
send	изпращам
stay	оставам
candy	бонбон
put	дявам
put on	надявам
put on	надяна
fill	пълня
fill	изпълвам
fill	изпълня
carry out	изпълнявам
change	ресто
big top	шапито
loanword	чуждица
maniac	маниак
epic	епос
resemble	приличам
let	пусна
ask	запитам
ask	запитвам
подкре́па	окажа
подкре́па	оказвам
let	позволя
let	позволявам
bring near	приближа
bring near	приближавам
tell	разкажа
tell	разказвам
follow	следвам
follow	последвам
drag	мъкна
pull out	измъкна
pull out	измъквам
appearance	поява
leave	напусна
leave	напускам
presume	предполагам
presume	предположа
change	променя
change	променям
at last	накрая
stand	застана
put off	бавя
add	добавя
add	добавям
collect	прибера
collect	прибирам
collect	събера
collect	събирам
bra	сутиен
bookcase	етажерка
brake	спирачка
confectionery	сладкарница
pottery	грънчарница
cartshop	коларница
tailor	шивачница
shoemaker	обущарница
barbershop	бръснарница
pass by	минавам
clean	изчистя
clean	изчиствам
civil	граждански
come across	случа
come across	случвам
do	сторя
do	сторвам
consulate	консулство
credit card	кредитна карта
remaining	останал
receipt	разписка
battery	батерия
pen	писалка
send	посилам
testicle	мъдо
bakery	пекарна
winery	винарна
brewery	пивоварна
foundry	леярна
stone quarry	каменоломна
creamery	маслобойна
custom house	митница
carpentry	дърводелница
place	доярна
bedroom	спалня
waiting room	чакалня
anvil	наковалня
wash house	пералня
feeding room	поилня
bathroom	къпалня
place	доилня
washroom	умивалня
debate room	говорилня
reading room	читалня
confessional	изповедалня
hothouse	сушилня
factory	оръжейна
hatching room	люпилня
kindergarden	занималня
dissension	препирня
sulking	сръдня
vomit	повърня
piss	пикня
diarrhea	дрисня
fart	пръдня
rupture	пробойна
defense	отбрана
reception room	приемна
drawing room	гостна
living room	всекидневна
turf	блана
alms	милостиня
tool	оръдие
lightning	светкавица
canteen	столова
secretly	скришом
pile	кладня
spectator	зрител
at home	вкъщи
Romanian	румънец
Romanian	румънка
last night	снощи
centre	средище
sacred object	светиня
wrestler	боркиня
begger	просякиня
slave	робиня
servant	слугиня
housewife	домакиня
Sofia	Витиня
hook	вител
swimmer	плувец
swimmer	плувкиня
Bulgarian muslim	помакиня
darling	драгиня
changing room	съблекалня
breakfast room	закусвалня
smoking room	пушалня
swimming pool	плавалня
sauna	потилня
smeltery	топилня
orphan	сиротиня
treat	черпня
liar	лъжкиня
duke	херцог
duchess	херцогиня
demon	дивиня
fuss	суетня
poking	ръгня
swear word	ругатня
trough	копаня
scuba diver	гмуркиня
thief	крадла
ring	брънка
ring	пръстен
who	какъвто
whatever	каквото
suddenly	изведнъж
once	веднъж
forever	завинаги
take	поемам
spread	постилам
broken	крън
castrated	кърнак
wilderness	пущинак
stone	камънак
weed	буренак
thorn	трънак
Bulgarian	потурнак
middler	средняк
caveman	пещерняк
male westerner	западняк
reservist	запасняк
ljutenica	лютеница
glass bottle	стъкленица
circular	любеница
sausage	наденица
tag	гоненица
hide and seek	криеница
chapelet	броеница
deliverer	доставчик
welder	заварчик
adjuster	настройчик
receiver	приемчик
да помо́гна	всякак
all kind	всякакъв
biceps	мишница
whose	чийто
impurity	глота
titch	мъник
limestone	варовик
packer	опаковчик
beech grove	буковик
hump	гърбица
fiancé	годеник
fiancée	годеница
matchmaking	годеж
present	представям
present	представя
receive	приемам
marry	оженвам
marry	оженя
sense	усет
feel	усещам
feel	усетя
somewhere	някъде
elsewhere	другаде
remind	спомня
genitive	родителен
near	наблизо
insist	настоявам
tie	вържа
tie	връзвам
be	бивам
refuse	отказвам
refuse	откажа
mark	означавам
mark	означа
convulsion	гърч
noise	глъч
bile	злъч
compression	гъч
dense crowd	гмеж
later	по-късно
footstep	крачка
admit	призная
hand in	предавам
examine	оглеждам
examine	огледам
examination	оглед
без о́глед на	без оглед на
с о́глед	с оглед
piece	отрязък
order	порядък
excrescence	израстък
excess	излишък
written entry	списък
progress	напредък
shortage	недоимък
hue	оттенък
excerpt	извадък
livelihood	поминък
yolk	жълтък
waste	отпадък
fragment	отломък
remainder	остатък
scroll	свитък
livestock	добитък
hammering	забитък
data	податък
rudiment	зачатък
spoilt egg	запъртък
albumen	белтък
nous	разсъдък
imprint	отпечатък
section	участък
seizure	припадък
furnace	пещ
hide	скрия
hide	скривам
direct	насоча
direct	насочвам
transform	превърна
transform	превръщам
whisper	шептя
whisper	шепна
whisper	прошепна
whisper	прошепвам
take down	сваля
take down	свалям
bend	свия
bend	свивам
hand	подавам
want	поисквам
squeeze	стискам
squeeze	стисна
squeeze	стисвам
afraid	страхувам се
slice	рязвам
slice	рязна
run away	избягам
run away	избягвам
often	повечето
feel	почувствам
step	стъпя
step	стъпвам
step	стъпка
mixture	бъркоч
urine	пикоч
vomit	бълвоч
coiling	въркоч
rot	гнилоч
dumbhead	главоч
croaking	къркоч
gang	сволоч
idiocy	глупоч
laugh	смея се
tell	явя
announce	явявам
announce	заявя
announce	заявявам
let go	отпусна
line up	редя
line up	наредя
line up	нареждам
breathe	дъхна
breathe	дъхвам
sigh	въздъхна
sigh	въздъхвам
far	далече
jump	скоча
lend	заемам
consciousness	съзнание
please	радвам
demogeron	демогеронт
ask	помоля
ask	помолвам
along	покрай
point	посоча
point	посочвам
transport	прекарам
transport	прекарвам
put	качвам
slipper	чехъл
see	зярвам
suspect	подозирам
suspect	подозра
see	зярна
sight	зърна
glimpse	зървам
gingerbread	меденка
honey bread	меденица
graduate education	висше
chunk	дебляци
shrub	тръне
fruit	грозде
bushes	храсте
meatball	кюфте
trees	дърве
gravel	камъне
reap	жъна
sparks	искря
jealous	ревнив
of	дьо
stack	наложа
stack	налагам
claim	ищай
wish	ищах
sparrow	врабей
scorpion	скрапей
scree	сипей
cap	грездей
piece	къшей
lichen	лишей
carbuncle	цирей
chandelier	полилей
dandruff	пършей
piece	кършей
just now	току-що
converse	разговарям
converse	разговоря
free	освободя
free	освобождавам
wave	махна
chance	случайност
Dobrynya	Добриня
great	-мир
collusion	мирба
fate	съдба
theft	татба
omen	поличба
sign	личба
partitioning	подялба
division	дялба
parting	раздялба
compliment	хвалба
embroidery	везба
ration	дажба
complaint	тъжба
fire	стрелба
arrangement	подредба
ordinance	разпоредба
system	уредба
medicament	целба
fortune telling	врачба
financial loss	жладва
medical treatment	лечба
sanctification	святба
greed	алчба
inquiry	просба
distress	страдба
-ш	-вш
having eaten	явш
having granted	давш
generous	дашен
любвеоби́в по душа	любвеобив
loving	любвеобилен
-ш	-авш
having been stricken	пострадавш
-ш	-ивш
winning	печеливш
incurable	нелечим
dissoluble	разтворим
reachable	достижим
impossible	незаличим
delible	заличим
caress	галба
wonderful	чудим
leading	водещ
unfightable	необорим
refutable	оборим
repeatability	повторяемост
repeatability	повторимост
-ш	-евш
having suffered	потърпевш
formerly flying	летявш
formerly running	вървявш
knuckleheaded	гламав
grubby	мърляв
misty	мъгляв
ashy	пепеляв
mushy	кашкав
grayish	сивкав
bluish	синкав
reddish	червеникав
yellowish	жълтеникав
sweetish	сладникав
bland	блудкав
gluey	лепкав
chubby	пухкав
blackish	черникав
friable	сипкав
standing	нарицаем
cognizable	познаваем
binding	повеляем
foundable	откриваем
slippery	хлъзгав
glib	плъзгав
unsavable	неспасяем
saveable	спасяем
traceable	проследяем
red-headed	рижав
shiny	бляскав
ragged	дрипав
curly	къдрав
glacé	лъскав
disabled	недъгав
loose	рехав
rough	грапав
toothless	щърбав
hunchbacked	хърбав
secretive	скривш
stingy	скръбав
stingy	скърчав
stingy	скрежав
pitiful	жалостив
hateful	злобив
rotational	въртелив
hot	лютив
pale	мъждив
impious	нечестив
diligent	радив
covered	пършив
factitious	фалшив
grubby	червив
patriotic	родолюбив
hydrophilic	водолюбив
vengeful	мъстив
-ish	-чив
pimpled	пъпчив
styptic	стипчив
astringent	тръпчив
pretentious	придирчив
mouse	мишле
bro	братле
man	мъжле
knife	ножле
neck	вратле
pepper	чушле
book	книжле
persistent	упорит
remarkable	бележит
eminent	именит
greasy	мастит
-y	-овит
big-mouthed	устат
big-toothed	зъбат
fibroid	власат
big-hearted	сърцат
facial hair	въсат
cross	кръстат
slant	полегат
-y	-оват
pointy	върхат
big eyes	очат
prominent back	гърбат
alate	крилат
wide	разлат
moss	мъхнат
woolly	вълнат
wearing glassed	очилат
hooded	качулат
wearing	гащат
gummy	гъвък
scorching	жежък
vigilant	зорък
ductile	ковък
mellow	пивък
chill	хладък
shallow	плитък
winded	витък
esculent	ядък
tight	узък
brittle	крехък
friable	ровък
vile	мерзък
capacious	емък
laborious	трудоемък
sour	бридък
fragrant	дъхав
hotheaded	сприхав
plaint	гибък
gooey	липък
youth	гидия
orator	вития
boat	ладия
saint	светия
boat	гемия
duct	бурия
costume	носия
jerusalem artichoke	гулия
ironware	железария
gluttony	лакомия
administrative unit	околия
covering	подвързия
beggary	просия
slavery	робия
pouring	разсипия
taking	разтурия
quarrel	разправия
trade	търговия
horror	ужасия
miracle	чудесия
beauty	хубосия
spite	проклетия
-ity	-отия
confusion	неразбория
jelly	пихтия
peat	озд
healer	балия
ballyhoo	патърдия
ride	возия
fix	оправия
unfortunate	завалия
futile	суе-
idle talk	суегласие
idle claim	суесловие
distance	хвърлей
raising	въстание
Middle Ages	Средновековие
high elevation	върховие
foreshadowing	предвестие
plane area	нивье
highness	височие
soundness	целомъдрие
fun	веселие
low elevation	низовие
evening	навечерие
jurisdiction	правосъдие
box	сандък
handcuffs	белезници
sledge	шейна
damage	поразия
tavern	кръчма
oyster	стрида
farm	чифлик
репу́блика	Чешка република
bogatyr	богатир
minister	министър
fear	боя се
spleen	далак
spleen	слезка
trifle	дреболия
gland	жлеза
millstone	жерка
yard	авлия
employee	служител
merchant	търговец
wife	тъща
husband	свекърва
pine groove	боровец
hornbeam groove	габровец
thorny thicket	търновец
dogwood groove	дряновец
walnut groove	оряховец
well-dressed	гиздавец
villain	лукавец
varmint	палавец
coward	бъзливец
coward	страхливец
sleepyhead	сънливец
stinker	смрадливец
stinker	миризливец
devoted	благочестивец
idler	мързеливец
quarantine	пазата
slattern	галатка
stepfather	пастрок
cold war	студена война
bad weather	дърча
banner	пряпорец
flag	пряпор
drift	пряспа
chairman	председател
fare misfortune	патя
raw material	суровина
shallow	плитковина
hole	язовина
rest	почивам
rested	почивш
drag	влека
crime	престъпление
thick mud mass	грезен
post peak	превал
elevation	брегалище
prolonged hummock	бърчина
ascent	стръмнина
steep dale	урва
cleft	пазина
sinkhole	карстова фуния
groove	дълбей
coarseness	крутина
gorge	жрело
path	пъртина
fjord	фиорд
stone run	каменна река
mountainous valley	прегиня
formation	напластяване
sheet	дайка
hollow	увал
comma	запетая
wedge	зъбер
landform	форма на релефа
col	преслап
thrust fault	навлак
offset	отсед
mounting	възсед
downgrade	разсед
armchair	фотьойл
indentation	вдлъбнатина
float	плавей
pit	ропа
square	площад
upland	възвишение
ditch	ровина
shady	усое
sunny	присое
excavation	роветина
wilder beast	диветина
crag	канара
curve	тулица
river terrace	речна тераса
ringer	бучало
sprinkler	пръскало
cascade	скакавица
thimble	напръстник
noodles	юфка
look	ненавиждам
ripple	рив
undulation	вълнение
rogue wave	вълна-убиец
capillary wave	капилярна вълна
gravity wave	гравитационна вълна
indignation	възмущение
remorse	покруса
emotion	емоция
jungle	джунгла
steel	стоманен
depression	депресия
forest	лесище
marsh	млака
curve	извивка
multiculturalism	мултикултурализъм
frosty	мразовит
icy	ледовит
unsteady	хлявав
fear	боязън
scorching	парещ
cross-eyed	вегав
mode	модус
malus	малус
freezing cold	бахър
cool	хладя
wind chamber	ветрилник
ice-cold chamber	мразилник
sludge	цад
feeder	хранилка
beast	зверилник
beam	светлик
aperture	стръга
article	статия
festival	русалия
hero	витег
circumstance	обстоятелство
playing	игрален
washing	миялен
virtual	виртуален
potential	потенциален
miserable	страдален
bathing	къпален
baptismal	кръщелен
washing	перилен
loyal	лоялен
farewell	прощален
seat	седалище
hangout	свърталище
cultural club	читалище
hideaway	скривалище
desk	писалище
rest place	питалище
bathing place	къпалище
fulfillment	достатък
disadvantage	недостатък
appendage	придатък
initiation	начатък
interim	промеждутък
bulge	издутина
billet	слитък
puppy	пале
cub	щене
boy	хлапе
cask	бъдне
palate	небце
foot	краче
meanwhile	междувременно
granule	зрънце
corpuscule	телце
muscle	мишца
glutton	ядца
clod	буца
claimant	ищец
claimant	ищца
slug	плужек
finish	завършек
end	свършек
clot	съсирек
weed	саморасляк
fragment	откъслек
circlet	кръжок
procession	върволяк
grass turf	треволяк
thick grove	дърволяк
dust	прахоляк
flight formation	орляк
riprap	трошляк
slug	плъж
little	пижо
snail	пижек
leech	пижавица
salamander	дъждовник
encounter	сретя
singlet	потник
saddle blanket	телтия
wooded	горист
swampy	блатист
grassy	тревист
purebred	породист
goldish	златист
silver	сребрист
stony	каменист
rocky	скалист
watery	воднист
dapple	петнист
undulate	вълнист
earthly	землист
lambant	лъчист
lambant	зарист
sparkling	искрист
expressive cheeks	бузест
expressive lips	бърнест
slimy	слузест
granular	зърнест
misty	мъглист
throaty	гърлест
woolly	вълнест
argillaceous	глинест
sinewy	жилест
toothy	зъбест
mossy	мъхест
fluffy	пухест
burden	тежест
sorrow	горест
freshness	свежест
jurist	правист
graduate	висшист
supporter	върховист
executor	сечца
bagpipe	гайда
neighboring	съседен
poetess	поетеса
duchess	дукеса
stewardess	стюардеса
facility	съоръжение
thin	възтънък
compel	бедя
lure	вабя
dowry	зестра
wilder place	генгерлик
doubt	съмнявам се
gambler	комарджия
saw	трион
pin	пирон
tower	пирг
rhyton	ритон
pylon	пилон
jumpsuit	гащеризон
radish	рапон
army commander	военачалник
union	унион
herbarium	хербарий
bastille	бастилия
harmony	хармония
urinate	уринирам
pressure	налягане
black grouse	тетрев
deaf person	глухар
repent	кая се
guineafowl	токачка
game bird	преперец
quail	пъдпъдък
falcon	крагуй
acidulous	красат
fortunate	благат
little owl	кукумявка
owlet	улулица
scavenger	лешояд
falcon	доган
bird of prey	граблива птица
cinereous vulture	картал
mouse	мишелов
turtle dove	гургулица
sandgrouse	пустинарка
sparrow	врабка
robber	апаш
jackdaw	гарга
spotted nutcracker	сокерица
turtle dove	гърлица
bird	гав
crow	гавка
croak	грак
magpie	сврачка
rook	къркавец
screech	крякот
screecher	крячка
passerid	сковран
throstle	дрозен
lark	сковранец
passerine bird	личинкоядка
jump scare	стреж
wren	орехче
wren	мушитрънка
coward	стрежко
wood nuthatch	бръглеш
gnatcatcher	комароловка
flypaper	мухоловка
robin	червеношийка
goatsucker	козодой
nightjar	мраченик
flying toad	летяща жаба
eyelid	клепач
fast flyer	бързолет
golden oriole	чичопей
finch	чинка
finch	чижка
mistle thrush	чигла
European goldfinch	щиглец
bunting	овесарка
crossbill	кръсточовка
canary	канарче
chatterer	дърдавец
land bird	крастел
great egret	кракал
во́ден бик	воден бик
limpkin	арама
turtle dove	туртулица
warbler	коприварче
hazel grouse	лещарка
bill	клъвка
wryneck	въртошийка
knife	ножче
sheath	кания
shoebill	китоглава чапла
hammerkop	чукоглава чапла
roadrunner	земна кукувица
fast walker	бързоходец
herring gull	гларус
wave-philic	вълнолюбка
sea	морелетник
guillemot	кайра
puffin	тъпоклюн
abstract	абстрахирам
fish	рибояд
cormorant	корморан
ibisbill	сърпоклюн
snipe	бекасина
sandpiper	кюкавец
coastal runner	брегобегач
three	трипръстка
shouter	крещалец
seabird	крея
plover	дъждосвирец
gentle chant	зуек
black-tailed godwit	кукунос
stork	щъркел
duck	шатица
shovelard	клопач
teal	бърне
oscillation	маница
diver	потапница
hoopoe	папуняк
great snipe	дубла
piper	свирец
kingfisher	рибарче
roller	синявица
eagle owl	буляк
floater	пловка
ringer	звънарка
swan	лебедица
stilt	кокилобегач
wagtail	стърчиопашка
darkness	тъмнина
shelduck	ангъч
shelduck	пеганка
tattler	бъбрица
seat	седалка
mocker	присмехулник
warbler	шаварче
reedling	тръстикарче
tree climber	дърволазка
remnant	останка
whisk	размахвам
crawl	пълзя
alas	уви
sadness	тъга
stature	ръст
famous	прочут
object	обект
inside	навътре
curiosity	любопитство
magpie goose	полуципеста гъска
screamer	паламедия
пти́ца носоро́г	птица носорог
jacamar	якамара
turaco	турако
curassow	кракс
tropicbird	фаетон
spotted crake	пъструшка
squeaker	цвъркач
wheatear	каменарче
bluethroat	синьогушка
bullfinch	червенушка
cherry	черешарка
grosbeak	тъпочовка
linnet	конопарче
cardueline finch	скатия
titmouse	гаяче
tanager	тангара
kinglet	кралче
silk	копринарка
sunbird	нектаринка
пти́ца тъка́чка	птица тъкачка
chick	пипе
waxwing	къжлица
seriema	кариама
пти́ца секрета́р	птица секретар
bird of paradise	райска птица
пти́ца ми́шка	птица мишка
Serbo-Croatian	сърбохърватски
nun	калугерица
peep	пигол
fold	чупка
tanning mush	щава
honk	га-га
peep	пи-пи
giggle	кикот
stool pigeon	мюре
church	черква
fair	панаир
thunder	гръмот
mattress	матрак
cook	готвя
remind	напомня
comma	запетайка
inexperienced	аджемия
inexperienced	аджамия
novice	аджемийски
inexperienced	аджемийка
novicehood	аджемилък
novicehood	аджемилъшки
inexperienced	аджамийка
novice	аджамийски
novicehood	аджамилък
novicehood	аджамилъшки
tree	яблан
sour	ягорида
hunter	авджия
graduate	абсолвирам
primrose	иглика
slowly	агале
Hagarene	агарянец
canvass	агитирам
agrarian	аграрен
agronomic	агро-
sheepfold	агъл
spinach	спанак
pillow	възглавница
emblem	емблема
quilt	завивка
cushion	дюшек
tardigrade	бавноходка
tell	хортувам
grumpy	сърдитко
obedient	послушко
parasitic bug	въгарец
tapeworm	тения
sucker	смукалник
кръ́гъл че́рвей	кръгъл червей
пло́сък  че́рвей	плосък червей
пре́шленест че́рвей	прешленест червей
ресни́чест че́рвей	ресничест червей
многоче́тенест че́рвей	многочетенест червей
малоче́тенест че́рвей	малочетенест червей
дъ́ждовен че́рвей	дъждовен червей
earthworm	смулец
creepy	гидюха
gastropod	бухер
sea sponge	сюнгер
Pimpinella	бедреница
whelk	рапан
coax	бедявам
caecilian	цецилия
unfortunate	кутсуз
cave bat	лепир
bug	буболечка
pupa	какавида
cricket	цвърчок
mole cricket	попово прасе
hawk	усорлица
insect	жегавица
granary weevil	гъгрица
earwig	щипалка
earwig	ухолазка
stink bug	миризливка
firebug	божа кравичка
leaf eater	листояд
aphid	листна въшка
silverfish	люспеница
по́лски кова́ч	полски ковач
scarabaeid	скарабей
dragonfly	водно конче
botfly	щръклица
springtail	вилоскачка
tiny	мижурка
bristletail	шипоопашка
day	еднодневка
predatory insect	овад
пръ́чица за я́дене	пръчица
scolding	хърдание
maggot	хърделка
scorpionfly	скорпионница
whisker	бърк
from now on	тепърва
woodcrafting chisel	скобел
outlying	затънтен
scold	хокам
move	хопам
observe	сматрям
pancreatitis	панкреатит
perceive	чутя
unfurl	разгръщам
unfurl	разгърна
subversive	подривен
undermine	подривам
undermine	подрина
detachment	отред
destroyer	изтребител
seemingly	комай
on one's deathbed	бера душа
immense	необятен
vehement	ожесточен
wrestle	боричкам
hunting dog	палаш
poke	ровичкам
tickle	гъделичкам
alpha and omega	алфа и омега
habit	навик
view	гледка
move	преместя
eavesdrip	капчук
role	роля
night	нощен
event	събитие
team	екип
predict	предвиждам
Emesa	Емеса
Emesene	емески
Palmyra	Палмира
Palmyrene	палмирски
figure out	измисля
figure out	измислям
crowd	тълпа
entertain	занимавам
cover	покрия
cover	покривам
Ephesian	ефески
geographer	географка
hose	маркуч
carpenter	дърводелец
cutie pie	сладур
crave	жаждя
into	сквозе
through	кръз
tick	кърлеж
brine	юха
Cytisus	зановец
green	ботур
good	харен
absolutism	абсолютизъм
strawberry tree	кумарка
haunch	ханш
lineage	леджа
shoe shaft	навуща
opanak	цървул
first of all	най-напред
shake	поклатя
well	въбел
fountain	източник
drainage	отточник
lisp	фъфля
blow	фуча
fury	ярост
weight	тегло
handcuff	белезница
handcuff	белезник
petrol	петрол
Trojan	троянец
shilling	шилинг
correspondence	съответствие
trouser leg	крачол
strapper	здравеняк
publisher	издател
traitor	предател
contact lens	контактна леща
bottle	бутилирам
prosaic	прозаичен
pass through	премина
crime scene	местопрестъпление
pavilion	павилион
pistol	пищов
kick	ритник
amitosis	амитоза
evil	злина
Old World dipteran	папатак
presence	присъствие
proof	доказателство
end	краище
pistol	пищол
loop	илик
wetnurse	дойка
jaundice	жълтеница
jaundiced	жълтеничав
pancreas	панкреас
huckster	търгаш
со кро́тце	со кротце, со благо и со малко кютек
elder brother	браташ
dear	драгаш
gentle	благаш
slender	дръглаш
protome	протоме
shin pad	наколенник
gilt	позлата
heyday	разцвет
millenarian	хилядолетен
millennium	хилядолетие
filing cabinet drawer	сандъче
ecstasy	екстаз
delight	възторг
admiration	възхищение
elementariness	елементарност
namesake	съименник
lawyer	адвокатин
whether	аджеба
adjutant	адютант
adjutant	адютантски
rhythm	ритъм
expedition	експедиция
neutrality	неутралитет
resist	устоявам
intelligentsia	интелигенция
elite	елит
unprecedented	безпрецедентен
enterprise	предприемчивост
enterprising	предприемчив
chronicler	хронист
rug	губер
female farmer	фермерка
farmer	фермерски
beat up	пребия
tall	дългуч
Tom, Dick and Harry	Сульо и Пульо
pandemonium	говория
medical splint	длага
agile	жекав
liquid	жидък
feel pain	жигуя
pardon	помилуя
criminal	разбойнически
criminal	разбойнишки
make laugh	засмея
make laugh	засмивам
silence	мълчание
simultaneously	едновременно
simultaneous	едновременен
speed	скорост
feeling	усещане
obligation	задължение
tragedy	нещастие
thread	гибам
не де́я	недей
mind	акъл
poetry	поезия
shipwreck	корабокрушение
bloodshed	кръвопролитие
constellation	съзвездие
humanity	човечество
parliament	скупщина
fellow traveller	спътник
soak	фир
goggle	пуля се
valley	юдол
cripple	юрод
absence	липса
enumeration	хем … хем …
kettlebell	пудовка
dumbbell	гира
cheat	измамвам
mustelid	собол
ground squirrel	соболец
exhale	пафкам
Baba Yaga	Баба Яга
Yarilo	Баго Яро
Sack Man	Дядо Торбалан
Father Christmas	Дядо Коледа
Baba Marta	Баба Марта
Old Man Winter	Дядо Мраз
Grozev	Грозев
cooktop	котлон
denounce	порицавам
rug	халище
vanity	халост
damp	мочер
amphibian	земноводно
salamander	саламандър
paddock	крастава жаба
rave	бълдам
tape recorder	магнетофон
pubescent boy	пубер
