ye	en
we	in
we	hit
he	ha
we	ham
we	ta
laud	tuna
water	agua
cheapen	rebaja
rope	tali
telephone	telefon
they	ma
five	lima
abandon	dingo
head	ulu
at	gi
and	ya
plenty	bula
desire	tanga
one	usa
I	hu
Chamorro dish	kelaguen
foot	addeng
walk	lahu
cowardice	kinibatde
what	hafa
bomb	bomba
store	tenda
thunder	hulu
broil	tunu
breast	susu
sugarcane	tupu
ash	apu
pig	babui
ship	bateo
Guam	Guåhan
one	maisa
one	hachiyai
two	hugua
two	hugiyai
six	gunum
five	lalima
five	limiyai
thou	hao
parrot	loru
louse	hutu
hair	pulu
and	yan
footwear	dogga
sea	tasi
they	siha
liquor	arak
dead	matai
egg	lotsa
home	guma'
road	chalan
maggot	ulo'
rain	uchan
ear	talanga
fly	lalo'
mosquito	ñamu
forehead	ha'i
bone	to'lang
land	tano'
roof	atof
thou	hagu
raw	mata'
shrimp	uhang
wake	pangon
kill	puno'
wait	nangga
knife	se'se'
urine	me'me'
plant	tanom
sand	unai
wood	hayu
hanom	hånom
female	palao'an
because	sa'
comprising	doga
chin	achai
goblin	duendes
night	puengi
knife	sese'
cry	tanges
sail	layak
abandoned	maabandona
abandoned	madingo
abandoned	mayute
cheapen	nalábarato
cheapen	lumábarato
comprise	togtog
demolition	tinigua
crab	pånglao
culture	kuttura
we	hami
plant	tinanom
we	hita
paddy	fa'i
moss	lumot
I	guahu
be	guaha
pavilion	palapala
farmer	lancheru
United States	Estådos Unidos
God	Yu'us
government	gobietno
happy	minagof
read	taitai
rice	pugas
sky	långet
mortar	lusong
teeth	nifen
coconut	niyok
marriage	akkamo'
divorce	umayute'
new	pa'go
deep water	sahagu
four	fatfat
eight	gualu
nine	sigua
ten	fulu'
star	puti'on
I	yoʼ
he	gueʼ
ye	hamyo
he	guiya
key	yåbi
crustaceans	kulåles
salt	asiga
television	telebikbik
thimble	doddak
September	Lumamlam
wring	fugo'
