his	noun
you	en
mother	in
him	i
arrive	war
be	mi
you	ami
victory	win
name	it
pink	pink
boy	at
his	an
in	non
twenty	rue
dream	tan
shower	tutu
my	ai
angry	song
the	we
and	me
they	re
where	ia
you	ke
holy	pin
what	met
day	ran
sea	sat
say	era
fence	tit
one	et
them	ir
he	ese
the	ewe
bed	pet
drink	un
to	ne
those	kana
their	ar
tea	ti
one	eu
they	ra
betel nut	pu
us	am
million	minion
because	pun
cold	pat
if	ika
church	fan
our	ach
here	ikan
die	mano
torch	ton
devastated	ter
with	ren
fig	fik
my	nei
their	-er
I	use
great	nap
with	re-
am	ua
love	tong
who	io
tree	ira
depart	su
holy	fen
one	e-
his	-an
of	-in
out	-u
up	-tä
of	-en
of	-un
see	kuna
may	amo
yes	ewer
past	pas
breadfruit	mai
heaven	nang
we	sia
mouth	aw
bee	achi
there	ikana
kingdom	muu
room	rum
I	ute
intransitive verb	-i
poke	tiki
repeatedly	resin
right	pung
leg	peche
you	ka
these	kan
fifty	nime
he	a
God	Kot
shoulder	afar
father	sam
fish	iik
look	ne-
shoe	sus
hour	awa
stand	uta
light bulb	tama
body	inis
animal	maan
observe	katon
my	-ei
with	rei
goat	sike
hot	kar
build	aueta
your	-om
from	seni
hear	rong
that	ena
happen	fis
over	sar
long	taman
stomach	nuk
horse	arus
blue	araw
fight	fiu
until	tori
allow	mut
steal	sona
duty	wis
brown	kung
clothing	uf
open	suk
right	rait
exist	wor
remainder	nus
thirsty	kaka
wine	wain
Saturday	Ammon
cow	kou
sin	tipis
join	fiti
money	moni
grace	chen
our	-ach
us	kich
branch	pan
billion	pinion
never	-te
glory	ning
lose	kuf
song	kön
marry	kofot
they	rese
rainbow	resim
son	nau
like	sani
one	emon
search	kutta
war	maun
book	puk
you	ouse
sixty	wone
we	aua
believe	nuku
desolation	tatakis
quickly	-ne
garage	sako
smell	tini
water	konik
foolish	puch
sun	akkar
dog	konak
number	nampa
which	menni
temple	tempel
south	ör
belt	penit
clear	fat
he	esap
our	äm
master	masta
deny	amam
speak	fós
eat	mongo
our	-em
agent noun	sou-
turn	riki
message	poraus
glass	kinas
here	-to
come	feito
coffee	kofi
how many	fite
west	notou
garden	atake
school	sukun
before	mwen
rice	rais
word	kapas
I	u-
simple present	-se
you	-k
completely	-eno
calling	kökkö
person	chon
drunk	sakau
them	-r
painting	chunga
water	konuk
look	neno
send forth	kuno
mission	misin
use	nounou
how	ifa
year	ier
water	chaan
call	köri
second	seken
family	famini
ask	tingor
forty	faik
new	fö
just	chok
office	ofes
milk	minik
destroy	atai
spouse	punu
exhausted	pekus
you	kose
help	anisi
you	oua
bring	wato
wait	witi
egg	sokun
here	ikei
ripe	nup
perpendicular	penges
shark	poko
your	noum
two	turu
how many	fitu
enough	naf
week	wik
wagon	wakon
true	ennet
put	wa-
you	kese
purpose	popun
close	arap
person	aramas
Chuuk	Ruk
visit	churi
encourage	pesei
laugh	takir
sleep	mour
clear	fatafat
dig	tuu
order	tetten
leave	feino
now	iei
America	Merika
light	saram
lesson	nesen
away	-no
teach	aiti
begin	poputa
sick	semwen
very	fakkun
want	mochen
clock	kunok
smart	tipachem
thank you	kinisou
greatly	chapur
there	ikewe
easy	mecheres
hard	weires
think	ekieki
today	ikenai
also	pwan
give	ngeni
earth	fonufan
make	föri
lord	samol
spirit	ngun
good	allim
rule	annuk
reveal	pwarata
promise	pwon
heart	netip
work	angang
learn	kaeo
paper	taropwe
pray	iotek
read	anneani
be able to	tongeni
bad	ngaw
know	sinei
so	iwe
purple	forket
time	fansoun
I	ngang
right	wenechar
house	imw
listen	ausening
altar	antare
hungry	echik
when	inet
when	nupwen
thing	mettoch
reply	ponuweni
sacrifice	asor
in	-nong
big	watte
level	sassar
fork	fók
secret	monomon
medicine	safei
kill	nnieno
sheep	siip
try hard	achocho
arrow	assefich
confused	osukosuk
understand	weweiti
rule	nemeni
about	usun
high	tekia
wise	mirit
strong	pochokun
gospel	kapas allim
possible	tufich
plan	kokkot
praise	mwareiti
touch	attapa
feel	mefi
cloud	kuchu
hope	epinukunuk
cloth	mangaku
girl	fefin
together	-fengen
marry	pupunu
mountain	chuk
land	fonu
fulfill	apwonueta
scared	nuokus
lord	maing
so that	pwe
tooth	ngii
sandal	chorri
old	chinnap
little	ekkis
peaceful	kinamwe
greedy	maicha
all	meinisin
lie	mwaken
rat	nakkich
cat	kattu
chicken	chukȯ
car	sitosa
star	füü
vomit	mwus
red	parapar
white	pwech
suffer	riaffou
baptized	papatais
three	unungat
foolish	tiparoch
brother	pwii
disobedient	nukumach
temptation	sossot
accept	etiwa
flesh	futuk
by oneself	pwisin
you will	kopwe
repent	aier
change	siwini
box	pȯr
circle	foukumos
I will	upwe
they will	repwe
we	sipwe
I	usap
sword	ketinas
will	-pwe
Monday	Sarifan
Tuesday	Orru
moon	maram
Wednesday	Eunungat
Thursday	Eruanu
Friday	Enimu
Sunday	Raninfen
pants	rauses
sock	sitoking
missionary	misineri
T-shirt	sipwaringu
spicy	mwik
appear	pwä
endure	nikitu
bugle	rappwa
bird	machang
swim	tuken
bat	pöute
teach	afanafana
meeting	mwich
after	mwirin
some	ekkoch
contend	anini
stay	nonnom
try	sȯtuni
crazy	umwes
teaching	afanafan
remember	chechemeni
checkers	sikang
fan	saipë
spell	itechiki
feast	kametip
full	mėėt
fight	koum
contention	tipekoum
enter	tonong
hate	oput
good	murinnö
slingshot	pachingko
popular	iteföunȯ
use	aea
wind	asepwan
girl	nengin
four	ruanu
one	echö
two	ruechö
perfect	unusöch
smoke	supwa
anoint	epiti
explain	awewe
second	oruwen
fifth	animuen
first	aewin
third	aunungatin
fourth	aruanun
sixth	awonuen
tomorrow	nesor
seventh	efisuen
tell	ereni
great	napanap
city	teninimw
still	chuen
weak	apwangapwang
hold	kömwöch
statue	nios
study	stuti
darkness	rochopwak
story	tutunap
one hundred	ipuku
yesterday	naneu
go	fei-
blessing	feioch
go up	feitä
go inside	feinong
down	-tiw
ponder	ekipwichi
buy	kamö
important	auchea
thirty	inik
two	ru-
jump	mwet
delicious	annë
many	chommong
ant	nukukutong
action	föfför
hole	pwang
marker	ukukun
happy	pwapwa
these	ekkan
the	kewe
those	ekkana
become	winiti
doctor	tokter
snail	pwechar
vision	nemesepwi
first	akkom
store	sitowa
boyfriend	kamwet
verse	wokisin
whistle	ouwa
record	uruo
beloved	achengicheng
tear	kamwei
axe	kouk
good	öch
child	semirit
lightning	fifi
English	Ingenes
ground	pwun
one	efoch
sneeze	mwesi
pain	metek
hot	pwich
burning hot	pwichikar
burn	pwichi
we	aupwe
will	epwe
you	oupwe
you	kosap
cold	patapat
film	kachito
acne	rawaraw
born	uputiw
type	sokkun
virgin	föpun
move	mokut
anchor	angko
ship	sipw
one	efou
two	ruömön
ear	sening
nurse	kangof
content	masou
lose	poutano
you	-kemi
excited	meseik
flour	pinawa
eat	ochoch
mile	mwail
each	iteiten
us	-kem
us	-kich
step	kinikin
apart	-fesen
exchange	niwin
why	pwata
your	omw
your	ämi
sit	mȯt
poor	woungaw
bad	-ngaw
table	chepen
entertainment	urumot
Christmas	Kirisimas
because	pokit-
shark	poku
guide	emwen
stove	sitof
garbage	kapich
race	kitir
truck	taraku
bathroom	pinchë
see	weri
Germany	Toowis
Germany	Ttooyis
woman	nemin
woman	feefin
pretty	niyééch
attractive	eniyéchchúúw
stone	faaw
we	ausap
we	sisap
you	ousap
they	resap
future	-sap
will	-pwap
grab	turufi
toward	-ngeni
airplane	sepenin
patience	engino
thorn	fönufön
wheat	wiit
tire	taia
serpent	serepenit
jealousy	nonowo
gift	niffang
pillar	u̇r
kill	nieno
rest	asösö
religion	namanam
pride	namanam tekia
wave	nȯ
prison	kanapus
help	aninnis
head	mökur
foot	kumwuch
hand	paaw
knee	pwasuk
choosy	nifinifin
rainy	pu̇ng
you	oupwap
you	ou-
kind	umöumöch
dance	pwöruk
paint	peinit
paint	chungani
clap	episipis
cry	puchor
north	ennefen
east	ötiw
dress	ufouf
naked	seneno
breath	ngasangas
forever	feinfeino
eternal	fochofoch
donkey	tongki
grass	fetin
river	chönupupu
worm	nikanipwun
boundary	kiȧn
remove	pwiniti
night	pwin
facial hair	enis
two hundred	rupuku
three hundred	unupuku
four hundred	föpuku
five hundred	nimepuku
hundred	-puku
four	fömön
five	nimmön
six	onumön
eight	wanimön
nine	tiwemön
ninety	tiwe
seventy	fiik
seven	fumön
three	unumön
how many	fitemön
fire	ekkei
sweet-smelling	pwokus
continue	sopweino
exact	tichik
thought	ekiek
three	unuchö
five	nimechö
eight	wanichö
denote	-chö
nine	tiwechö
seven	fuchö
four	föchö
six	onuchö
how many	fitechö
sexual intercourse	nisou
some	ȯch
one thousand	engöröu
nine thousand	tiwengöröu
nine hundred	tiwepuku
thousand	-ngöröu
Bible	Paipel
your	-emi
exist	awora
greater than	nap seni
polish	echeriw
boy	atewe
girl	neminewe
belongings	pisek
young man	anuön
mourn	noninen
excuse	tirow
circumcise	sirkumsais
cross	irapenges
Christian	sounang
two	rue-
how many	fitefou
two	ruefou
priesthood	pristut
scripture	pukepin
bicycle	pasiken
blow one's nose	fongoti
noon	neanowas
evening	nekunion
left	peniefefin
right	peniemwan
side	penie-
olive	olif
worry	aurek
devil	tefin
fertilizer	koiasi
spoon	sipun
cooking pot	ainipwoch
cloth	firoski
their	nour
our	nöu̇m
tax	takises
button	pwachen
bee	sisata
same	nönö
bee	chunen
mosquito	nikken
acquire	äni
acquire	nouni
sleep	annut
our	nöüch
your	noumi
lore	itang
life	manau
salvation	amanau
command	annuku
Satan	Setan
resurrection	manausefan
again	-sefan
atonement	achasefan
sad	netipengaw
hurt	feingaw
humble	tipetekison
interview	interfiu
certificate	setifiket
hold	komoch
sacrament	sakramen
shake	chech
rain	wúút
clean	nimenimoch
