butter	may
grandmother	abay
abortion	abort
ten	on
width	en
he	o
shallow	say
dog	it
tambourine	dare
left	sol
hand	el
moment	an
oath	ant
back	art
I	men
honey	bal
prayer	dua
older sister	dada
every	er
face	bet
shrinkage	fire
sofa	set
estimation	ball
one	bir
club	klub
major	mayor
fashion	mot
gamut	gamma
stable	dam
father	baba
manifesto	manifest
who	kim
board	qona
novel	roman
cope	qap
ball	top
fur	ton
prison	apis
apple	alma
island	ada
teacher	oca
mass	massa
branch	filial
March	mart
agitates	agitator
whale	kit
cash	para
underground	metro
door	porta
this	bu
second	bana
sister	tata
month	ay
family	ayle
petrol	benzin
vote	rey
camera	kamera
mathematician	matematik
helva	elva
photographer	fotograf
mathematics	matematika
wedding feast	toy
few	az
maternal uncle	dayı
teeming	tam
rust	tot
rich	bay
building	bina
custom	adet
tea	çay
rug	pala
bind	bint
screen	ekran
mother	ana
bread	baton
notebook	defter
you	sen
ayvanat	fauna
earth	yer
suv	mineral
firm	firma
room	oda
easiness	eb
headlight	fara
savanna	savanna
willow	tal
billion	milliard
defect	min
nebatat	flora
bass	bas
pistol	revolver
region	rayon
membrane	zar
cutter	kater
little brother	mata
microscope	mikroskop
philatelist	filatelist
screw	vint
house	ev
any	eş
sky	kök
me	maña
wire	tel
world	cian
dirt	kir
grandmother	nene
quadrat	kvadrat
pear	armut
faculty	fakultet
wagon	vagon
ballerina	balerina
four	dört
six	altı
three	üç
five	beş
seven	yedi
eight	sekiz
fire	ot
dog	köpek
that	şu
hour	saat
ballet	balet
barley	arpa
ice	buz
football	futbol
maybe	belki
star	yıldız
mire	çamur
window	pencere
Ukraine	Ukraina
universe	dünya
name	nam
accord	akkord
tongue	til
friend	dost
grandmother	bita
alive	tiri
continent	kontinent
wound	cara
almond	badem
experiment	eksperiment
quadrat	kare
kerchief	marama
child	bala
figure	figura
gas	gaz
brigade	brigada
ghetto	getto
advocate	advokat
now	endi
barge	barja
flower	çiçek
pepper	biber
main	magistral
tare	dara
poison	zeer
two	eki
coal	kömür
corridor	koridor
lampshade	abajur
mullah	molla
marble	mermer
head	baş
postmark	marka
time	kere
phonetic	fonetik
we	biz
prayer	namaz
gale	cel
much	köp
cancer	rak
tuberculosis	verem
big	büyük
milk	süt
color	renk
pearl	inci
stage	estrada
difficult	zor
war	cenk
tell	demek
fifty	elli
soap	sabun
pomegranate	nar
carp	karp
salt	tuz
cinema	kino
stable	aran
phosphorus	fosfor
wind	yel
steel	çelik
defect	brak
code	kod
full	tolu
walnut	ceviz
paw	panca
love	sevmek
ox	öküz
tent	çadır
ground	cer
blood	qan
coco	kokos
young	caş
pitchfork	yaba
wasp	sona
tekaran	teran
block	blok
jezve	cezve
zero	sıfır
seaman	matros
eye	köz
swine	domuz
night	gece
folk song	cır
concrete	beton
heavy	avur
rape	raps
cream	krem
farm	ferma
worse	бетер
rug	kilim
shower	duş
white	beyaz
harvest	arman
big	balaban
little brother	bata
cash desk	kassa
estuary	liman
patty	pite
reform	reforma
crane	turna
continuous	vira
he	anav
beloved	sevgili
commutator	kommutator
bazaar	bazar
cake	keks
cypress	servi
potato	patates
year	yıl
regatta	regata
republic	cumhuriyet
bug	böcek
spring	baar
cardboard	karton
cotton	keten
capital	kapital
book	kitap
May	mayıs
vengeance	öç
sixty	altmış
millimetre	millimetr
kilometer	kilometr
centimeter	santimetr
quid	qadaq
roentgen	rentgen
cat	mışıq
coagulated	qatıq
poor	puqare
life	ayat
forehead	mañlay
mother	anniy
brother	abiy
wood	ağaş
stable	ağıl
good	aruv
breath	tınış
navel	kündük
home	üy
barrel	metiy
byre	azbar
spider	biy
for	bosıntay
threshold	bosaqa
bat	carğana
voice	davuş
early	erten
room	işker
old woman	qartiy
zipper	cırcır
singer	keday
yesterday	tünevin
water	suv
turkey	körel
heart	cürek
sleep	yuqu
cheese	penir
take away	aketmek
eat	aşamaq
peel	arçımaq
become	avurmaq
overturn	avdarmaq
drive	aydamaq
stick	cabışmaq
beg	calbarmaq
hide	caşırmaq
shower	cavmaq
obstinate	erişmek
goad	qadamaq
hoary	qartaymaq
look at	qaramaq
back	qaytmaq
fit	kelişmek
lock	kirtlemek
praise	maqtamaq
mount	minmek
shy	uyalmaq
untie	şeşmek
sift	şeltemek
ooze	şıbırmaq
relative	asaba
foal	alaşa
turkey	ataman
bear	ayuv
man	aqay
sifter	şeltek
stick	tayaq
earring	sırğa
tray	sıpra
fly	şibin
mute	saqav
patch	camav
hole	teşik
tree	terek
last year	bıltır
mare	baytal
wolf	börü
bitch	qancıq
trap	qapqan
grandfather	qartbabay
hard	qattı
baked	kerbiç
pear	kertme
pigeon	kögerçin
rabbit	qoyan
vessel	savut
to	saylamaq
cool	salqın
blind	soqur
child	sabiy
wee	vaq-tüyek
here	mında
fasting	oraza
trivet	oçaq
just	azaqay
bitter	aççı
hot	cıllı
light	carıq
soft	cımşaq
festering	çılqa
elder	ülken
quail	bödene
fur	börk
bud	bür
bureau	büro
bureaucrat	bürokrat
be	bereket
duty	bergi
toll	bedel
baby	bebey
step	adım
notice	afişa
week	afta
veer	devir
beech	bik
neutral	bitaraf
loan	borc
paint	boya
damp	dım
damp	dımlı
dampness	dımlıq
dacha	daça
she	dişi
shawl	cavlıq
bundle	boqça
food	aş
flea	bürşe
match	sernik
matchbox	sernik qutusı
butter	sarı may
deaf	sağır
grasshopper	sekirge
urine	siydik
miser	mıqıy
nail	mıq
mire	mırıq
bead	moşaq
grape	yüzüm
chimney	çığaraq
large	çılapçı
pot	badiye
naked	çıpalaq
facial expression	şıray
knot	tüyür
miss	sağınmaq
wolf	qaşqır
abbot	abbat
abbreviature	abbreviatura
subscription	abonement
subscriber	abonent
boarding	abordaj
aboriginal	aborigen
abortive	abortiv
abracadabra	abrakadabra
abrasive	abraziv
absolute	absolüt
adaptation	adaptatsiya
agency	agentlik
agrarian	agrar
aggression	agressiya
aggressor	agressor
agronomist	agronom
vanguard	avangard
advance	avans
adventure	avantüra
adventurer	avantürist
adventurous	avantüristik
off	avlaq
from	avlaqtan
autobus	avtobus
autograph	avtograf
automatic	avtomat
automatic	avtomatik
automobile	avtomobil
fountain	avtoqalem
alphabet	elifbe
abstract	mücerret
author	müellif
autonomous	muhtar
authority	nufuz
authoritative	nufuzlı
apricot	qaysı
indentation	satır başı
apricot	zerdali
make	yasamaq
sleep	yuqlamaq
construct	saldırmaq
fare	barmaq
cry	cılamaq
northern	narat
number	nomera
homeland	vatan
sour cherry	vişne
comma	virgül
jubilee	yübiley
horizont	ufuq
button	dögme
dört	dört yüz
fourth	dörtünci
too	daa
sea	deñiz
acid	aşıtmaq
administrative	memuriy
administration	memuriyet
aerodrome	uçqunar
iceberg	buzdağ
mountain	dağ
advocate	abulqat
alphabet	alfavit
aluminium	alümin
album	albom
amoral	ahlâqsız
English	ingliz
Albania	arnavut
baked	tola
common cold	tımav
flat	calpaq
paralysis	nüzül
pottage	botqa
woman	apaqay
second	ekinci
third	üşinci
third	üçünci
thirty	otuz
üç	üç yüz
thirteen	on üç
fifteen	on beş
sixteen	on altı
five hundred	beş yüz
nine	doquz
six hundred	altı yüz
twenty	yigirmi
twelve	on eki
one hundred	bir yüz
fourteen	on dört
seventeen	on yedi
eighteen	on sekiz
nineteen	on doquz
two hundred	eki yüz
forty	qırq
seventy	yetmiş
eighty	seksen
ninety	doqsan
seven hundred	yedi yüz
eight hundred	sekiz yüz
nine hundred	doquz yüz
fortieth	qırqıncı
thousand	miñ
thousand	biñ
pedestrian	piyade
analysis	analiz
buck	buğa
ticket	bilet
white	aq
neck	qafa
barrow	bayır
day	kün
dialect	şive
for	içün
friendship	dostluq
embryo	embrion
embryonic	embrional
unity	birlik
jury	jüri
sacrifice	qurban
giraffe	jirafe
caviar	havyar
chestnut	kestane
level	sınıf
hoop	köpçek
barn	anbar
well	quyu
easy	yengil
list	cedvel
spouse	qadın
yüke	yüke teregi
bale	belâ
face	çere
fox	tilki
page	tabaq
love	sevgi
flower	şeşek
turn	aylanmaq
baba	babay
female	başmaq
trouser	balaq
bow	bav
beeswax	balavuz
lot	bir talay
liver	bavur
dog	boşıq
hail	burşaq
sparrow	boztorğay
bogy	böküy
flaky	cantıq
ancient	cartı
shower	cavun
naughty	canay
Easter	yavur yüzi
candy	qanpet
adhere	şıbaşmaq
rub	oqalamaq
meal	temeş
fit	keliştirmek
egg	cımırta
prairie dog	cercumuran
nanny	neniy
intentionally	paqıl
trousseau	satuv
water	suvbaqa
wick	melte
stirrup	telbev
buffer	bufer
buffet	bufet
budget	bücet
bulletin	bülleten
bust	büst
storm	furtuna
boulevard	bulvar
tug	buksir
beard	saqal
baggage	bagaj
kermes	qırmız
base	baza
bacterium	bakteriya
balalaika	балалайка
drum	trampete
ram	qoy
dye	tüs
bas relief	barelyef
barricade	barrikada
basin	basseyn
basketball	basketbol
battalion	batalyon
battery	batareya
birch	qayin
billiard	bilyard
biology	biologiya
turquoise	ferüze
light	yıltırav
notebook	bloknot
Bulgarian	bulğar
come	kelmek
go	ketmek
spill	sebelemek
furrow	barazna
war	küreş
barrel	varel
kid	kadâ
tarpaulin	brezent
brigade	brigadir
razor	ustra
shave	tıraş etmek
ford	keçit
coast	qaş
bronze	tunç
bronchitis	bronhit
coil	qalaç
every	er kün
wake	uyatmaq
ventilator	ventilâtor
barn	ambar
kitchen	aşqana
ram	qoşqar
piles	mayasıl
bread	ökmek
sheep	qozu
peel	capırmaq
nap	cantaymaq
selection	saylav
September	sentâbr
vertical	vertikal
you	siz
crow	qarğa
lie down	alşaymaq
replace	avuştırmaq
stink	sasımaq
burn	canmaq
burn	yanmaq
lie	yatmaq
send	cibermek
go to bed	catmaq
find	bavını tapmaq
close	capmaq
wet	cibimek
conceited	allegim
game	aqsüyek
wagon	angiş
pole	arış
childhood	balalıq
children	bala-çağa
çalbaş	calbaş
dung	capma
fruit	cemiş
brass	cez
nude	calanğaş
pedestrian	cayav
feast	cıyın
docile	cuvaş
stepfather	ögey baba
autumn	küz
sweeper	sipirtki
hair	saç
foe	duşman
raven	quzğun
every time	er daim
jackdaw	çavke
nail	mıh
gaiter	getralar
hymn	gimn
recover	aruv bolmaq
see someone off	ozğarmaq
gossip	öşeklemek
mislay	coytmaq
seek	qıdırmaq
seal	ıslamaq
wall	qalamaq
climb	şımaşmaq
pin	tüyremek
brooch	tüyreviş
thus	bulay
how	qadiy
how	qadiysiñ
doing	qatesiñ
where	qayerge
where	qayda
this	mınyaqqa
bitter	accı
hypnosis	gipnoz
mustard	hardal
clay	balçıq
pigeon	gögercin
throat	boğaz
bugle	gorn
Greek	yunan
Crimean	urum
thick	sıq
thickness	sıqlıq
caterpillar	tırtır
rubber	rezina
then	soñ
then	soñra
onion	soğan
zinc	çinke
kiss	öpmek
sugar	şeker
June	iyün
champion	çempion
cheque	çek
shepherd	çoban
seagull	çağala
teapot	çaynik
greatcoat	şinel
row	şerenga
look in on	coqlamaq
fall	cığılmaq
knock	cıqmaq
wash	cuvmaq
shine	cıltıramaq
come	cılışmaq
fun	cıynamaq
soften	cımşamaq
sticky	cuqmaq
hide	cıymaq
gather	cıyıştırmaq
run	cuvurmaq
bath	cuvunmaq
warm	cılınmaq
warm	cılıtmaq
lost	coytulmaq
tremble	qaltıramaq
octopus	sprut
sadism	sadizm
fish	sazan
saiga	sayğaq
salad	salata
salute	salüt
sanatorium	sanatoriy
sprinkle	sepmek
box	şimşir
sanation	sanatsiya
sanguine	sangvinik
sandals	sandalet
hospital	sanitar
sanitary	saninstruktor
sanction	sanktsiya
sapphire	sapfir
scatter	cayratmaq
crumble	vatmaq
undress	taşlanmaq
find	tapmaq
trample	taptamaq
look forward	tamşanmaq
commune	kommuna
sarcasm	sarkazm
sarcoma	sarkoma
satan	şeytan
satellite	satellit
satire	icviye
satirist	icviyci
satirist	eccav
satiric	icviy
saccharin	saharin
sucrose	saharoza
vermicelli	laqşa
bore	burav
sweater	sviter
lead	qurşun
dawn	tañ
freedom	serbestlik
freedom	azatlıq
pope	papaz
seance	seans
sturgeon	süyrü balıq
village	köy
segregation	segregatsiya
season	mevsim
seismology	seysmologiya
secret	sır
clerk	kâtip
secretion	sekretsiya
sectarianism	sektantlıq
second	sekundant
stop	sekundomer
section	sektsiya
saltpetre	selitra
majority	köbisi
barefoot	capıldaq
crybaby	cılavuq
bright	cıltıravuq
bitchy	cınasır
stone	taş
stony	taşlı
nominee	namzet
selection	selektsiya
selenium	selen
semantics	semantika
semaphore	semafor
sickle	oraq
seminary	seminariya
water pipe	vodoprovod
railway	elektriçka
helpless	aciz
left-handed	solaqay
lazy	erinşek
short	şontuq
cabin	kabina
cabinet	kabinet
cadre	kadr
Kazakh	qazah
calorie	kaloriya
campaign	kampaniya
company	kompaniya
candidacy	kandidatura
office	kantselâriya
chapel	kapella
hat	şlâpa
capitalism	kapitalizm
capitalist	kapitalist
capitalistic	kapitalistik
captain	kapitan
capitulation	kapitulâtsiya
capitulate	kapitulirlemek
cabbage	qapısta
career	karyera
caricature	karikatura
carnival	karnaval
chart	harita
potato	qartop
cashier	kassir
catacombs	lağım
category	kategoriya
café	kafe
cabin	kayuta
quarter	kvartal
apartment	kvartira
fasting	zappar
receipt	kvitantsiya
April	aprel
cypress	kiparis
oxygen	oksigen
cybernetics	kibernetika
scoop	çömüç
nail	tırnaq
kilogram	kilogramm
strengthen	begitmek
give	bermek
flick	şertmek
bolt	şeklemek
shout	cekirmek
bounce	sekirmek
bore	teşmek
interfere	kirişmek
enter	kirmek
film	kinostudiya
cinema	kinoteatr
film	kinofestival
film	kinofilm
bone	süyek
classic	klassik
classification	klassifikatsiya
stamp	tamğa
oil	sırlı keten
climate	iklim
clinic	klinika
clown	kloun
codeine	kodein
codification	kodifikatsiya
codification	kodifikatsion
coefficient	koeffitsiyent
every	er kim
Cossack	qazaq
collective	kollektiv
collectivization	kollektivizatsiya
collector	kollektsioner
collection	kollektsiya
knee	tiz
column	kolonna
command	komanda
commander	komandir
give	komanda bermek
commander	komandan
combine	kombayn
combine	kombayncı
group	kombinat
combination	kombinatsiya
comedy	komediya
commandant	komendant
commandant	komendatura
comment	kommentirlemek
comment	kommentariyler yapmaq
commissar	komissar
commissariat	komissariat
commission	komissiya
committee	komitet
compensation	kompensatsiya
compensate	kompensirlemek
compensation	kompensatsiya yapmaq
complex	kompleks
complete	komplekt
composer	kompozitor
composition	kompozitsiya
compromise	kompromiss
communal	kommunal
communism	kommunizm
communist	kommunist
communistic	kommunistik
conveyor	konveyer
convoy	konvoy
congress	kongress
capacitor	kondensator
confectioner	konditer
conductor	konduktor
concrete	konkret
thorn	tegenek
festival	tepreş
dishcloth	cuvğıç
tomato	domatis
truffle	domalan
washtub	eleken
hemp	kendir
hemp	kendir lifi
conservatory	konservatoriya
preserved	konservalar
conserve	konservirlemek
conserve	konserv yapmaq
synopsis	konspekt
conspiratory	konspirativ
conspiracy	konspiratsiya
basic assumption	konstatatsiya
constate	konstatirlemek
constitution	konstitutsiya
constructor	konstruktor
construction	konstruktsiya
construct	konstruirlemek
consul	konsul
consultation	konsultatsiya
consult	konsultirlemek
give	konsultatsiya bermek
contact	kontakt
continental	kontinental
administrative	kontora
contribution	kontributsiya
counter	kontrücüm
controller	kontrolör
control	kontrol
compere	konferansye
conference	konferentsiya
untidy	cayraq
wide	keniş
small	kişkene
stink	sasıq
cold	suvuq
strange	qucur
jealous	künçi
adept	şeber
allegedly	eken
concentration	kontsentratsiya
concert	kontsert
stall	ahır
cooperative	kooperativ
cooperation	kooperatsiya
copeck	kapik
tailbone	quyruq kemigi
boat	gemi
reporter	korrespondent
correspondence	korrespondentsiya
root	tamır
cow	sığır
king	qıral
queen	qıraliçe
short	qısqa
corps	korpus
scythe	çalğı
scythe	çalmaq
cosmos	kâinat
costume	kostüm
cauldron	qazan
cutlet	kotlet
coffee	qave
woman	kofta
landscape	landşaft
crane	kran
faucet	qurna
creditor	kreditor
cruiser	kreyser
silicon	kremniy
slanting	qıyış
scream	qıçıruv
cry	yayğara
crystal	kristall
criterion	kriteriy
back	sırt
east	küntuvar
west	künbatar
south	qıbla
trousers	ıştan
plaster	ıslav
mould	ırımşıq
storm	boran
rest	raat
steppe	şöl
hanger	şüy
smooth	tegiz
dark	qaranğı
stupid	tavkel
broom	sibirtki
sofa	sedır
step-	ögiy
kelinçek	kelinşek
ladle	çomıç
tea	şay
hair	çaç
tent	şalaş
mud	şamır
bleed	qanamaq
bloody	qanlı
nettle	qıcıtqan
crossword	krossvord
wheat	kürpe
sharp	sarplıq
Cuban	kubalı
basket	kuzov
fist	yumruq
coulisse	kulisa
culmination	kulminatsiya
culmination	kulminatsion
buy	satın almaq
coupon	kupon
vitriol	kuporos
banknote	kupüra
curator	kurator
chicken	tavuq
course	kurs
mattock	çoqaman
teacher	muallim
colander	keler
match-maker	cavşı
violin	gıygıy
clarinet	ğırnata
clarinet	borazan
fork	şatal
wheelbarrow	şana
twin	egiz
teapot	şaynik
eave	şaşaq
sledgehammer	şoqmar
hammer	şökiş
adze	şot
chick	şipşe
toothed	tişli
crystal	büllür
corner	köşe
evacuation	evakuatsiya
evolution	evolütsiya
evolutional	evolütsion
egis	egida
egoism	egoizm
equator	ekvator
examination	imtian
crew	ekipaj
ecology	ekologiya
economics	iqtisat
excavator	ekskavator
excursion	ekskursiya
exhibit	eksponat
express	ekspress
extremism	ekstremizm
electric	elektrik
electrification	elektrifikatsiya
electric	elektrostantsiya
emblem	emblema
emulsion	emulsiya
endocrine	endokrin
endocrine	endokrin bezler
energy	energiya
energetic	energetik
encyclopedia	entsiklopediya
encyclopedic	entsiklopedik
epidemic	qırğınlıq
episode	epizod
epitaph	kitabe
epithet	epitet
epicentre	epitsentr
epopee	epopeya
erosion	eroziya
air	eskadrilya
escalator	eskalator
relay race	estafeta
aesthetics	estetika
aesthetically	estetik
Estonian	estoniyalı
prototype	etalon
ethics	etika
ether	efir
echelon	eşelon
bad	osal
labyrinth	labirint
laboratory	laborant
laboratory	laboratoriya
bench	skemle
row	sıra
candlestick	lampat
laureate	laureat
cannon	top qundağı
lion	arslan
swan	aqquş
lieutenant	leytenant
lexis	leksika
lexicon	qamus
lecturer	lektor
lecture	lektsiya
lemon	limon
lime	yüke
bald	tazbaş
leaf	yapraq
November	noyabr
Lithuanian	litvan
post	poçta
postman	poçtacı
knight	rıtsar
many	ziyade
little	teranşıq
shy	tartınğaş
impudent	arsız
futility	caravsız
child	kence
silly	matüv
clothes	urba
leader	lider
hospital	hastahane
elbow	tirsek
lens	linza
best	eñ yahşı
good	yahşı
lyric	lirika
lyric	lirik
forest	orman
lantern	fener
goosefoot	alabota
stove	peşqa
oven	pırım
spade	kürek
burdock	qampa
flyer	uçucı
vicious	yavuz
February	fevral
bream	çabaq
peel	pul
shop	tükân
city	magistrat
magistrate	magistratura
magnet	mıqnatis
tape	magnitofon
plaza	meydan
macaroni	makaron
maximal	maksimal
mackle	makulatura
draft	resim
manoeuvre	manövr
manoeuvre	manövr etmek
cuff	manjet
manicure	manikür
mass	manifestatsiya
marathon	marafon
coop	ketek
ant	qımırsqa
swallow	qarılğaş
Marxism	marksizm
route	marşrut
massif	massiv
masquerade	maskarad
olive	zeytün
oil	yağ
continent	qıta
maternity	analıq
materialistic	materialistik
materialism	materializm
matter	madde
match	matç
machine	maşna
furniture	mebel
glutton	aşpit
blithe	vayımsız
cow	düve
great bustard	duvadaq
abhor	ciyrenmek
walk	cürmek
delight	quvanmaq
grow	ösmek
love	süymek
beloved	süygili
crepe	şırlama
memoirs	memuarlar
menu	menü
freeze	toñmaq
feel	üşümek
sweep	sipirmek
target	maqsat
metal	maden
meteorological	meteorologik
meter	metr
metric	metrik
mechanization	mehanizator
mechanization	mehanizatsiya
mechanism	mehanizm
mechanic	mehanik
soap	sabunlamaq
copper	baqır
therefore	ayse
before	aldında
front	aldı
behind	artında
bon appetit	aş bolsın
wassail	may baylasın
him	anavğa
that	nau
this	mınav
wash	yuvmaq
wash	yuvunmaq
mouse	sıçan
international	halqara
finger	parmaq
little	çinatiy parmaq
little	kiçik parmaq
little	ufaq parmaq
little	sıñarça parmaq
mine	menim
microbe	mikrob
microphone	mikrofon
shallow	saylıq
militarism	militarizm
become	saylaşmaq
militia	militsioner
facial expression	mimika
miniature	miniatüra
minister	nazir
ministry	nazirlik
mine	mina qoymaq
change	deñişmek
changed	deñiştirmek
change	başqalamaq
measurement	ölçü
measure	ölçemek
mill	degirmen
mission	missiya
bridge	köpür
city	şeer
salary	aylıq
meeting	miting
bellows	körük
heavy	qaviy
power	quvet
powerful	quvetli
force	küç
forceful	küçlü
force	qudret
forceful	qudretli
sack	çuval
great	çoqluq
mobilization	mobilizatsiya
mobilize	mobilizatsiya etmek
tell	aytmaq
say	söylemek
language	tilşınas
language	tilşınaslıq
possible	mümkün
brain	miy
brain	dimağ
wet	sılanmaq
wet	sılaq
molecule	molekula
wight	yigit
milky	sütlü
hammer	çöküç
monarchy	monarhiya
Mongol	moğol
silver	kümüş
cash	aqça
monologue	monolog
monopoly	monopoliya
montage	montaj
mount	montaj etmek
carrot	markof
ice	ayaz
morphology	morfologiya
mariner	deñizci
reason	sebep
spread	töşemek
ant	qırmısqa
hearsay	öşek
shirt	kölekse
dough	qamır
bean	paqla
careful	saq bolmaq
woman	qısqaayaq
aeroplane	tayare
towel	testimal
can	meşerpe
qırmısqa	qırmısqa yuvası
bee	çibin
motorcycle	mototsikl
motorcyclist	mototsiklist
will	hayal
wisher	hayalcı
fog	tuman
museum	müzey
masonry	qalav
weir	divar
mush	yımşaq
flesh	qıyma
factory	fabrıqa
phase	faza
factor	faktor
false	qalp
family	familiya
veneer	faner
will	hulya
china	çini
packet	paket
fascism	faşizm
federation	federatsiya
firework	fişenk
feuilleton	felyeton
doctor	feldşer
phenomenon	fenomen
phenomenal	fenomenal
feudalism	feodalizm
felt	fetr
violet	melevşe
figured	figuralı
physics	fizika
physiology	fiziologiya
physiologic	fiziologik
philosophy	felsefe
filter	filtr
filter	filtrlemek
filtered	filtrlev
finish	finiş
flank	flang
flute	fleyta
wing	fligel
foyer	foye
thought	fikir
brush	fırçı
fleet	flot
weathercock	flüger
folklore	folklor
base	negiz
dictionary	luğat
phonetics	fonetika
formulate	formulirlemek
piano	fortepyano
photo	fotoapparat
photo	fotosüret
part	parça
phraseological	frazeologik
phraseology	frazeologiya
Frenchman	fransız
function	funktsiya
food	aşaytlıq
clumsy	bayğuş
light	cengil
bee	balqurt
ruby	qan taş
quicksilver	künesuv
hand	qol
handicraft	el işi
sleeve	yeñ
work	iş
horn	müyüz
horn	boynuz
market	çarşı
fish	balıq
fisher	balıqçı
burdock	erkmen
hire	kâr
strap	quşaq
crawfish	qısqaç
shuck	qaburçaq
rib	qaburğa
ring	riñg
river	özen
glove	qolçaq
hurry	aşıqmaq
insane	alcımaq
ferment	aşımaq
stink	ciyimek
sharpen	qayramaq
Romanian	rumın
Romania	Rumıniya
satchel	ranets
glad	ferah
rabbi	ravvin
beet	turup
radical	radikal
serf	esir
helper	qul
rugby	regbi
yearly	yıllıq
yearly	senelik
creek	ırmaq
flay	sıdırmaq
towel	yüzbez
rucksack	rükzak
radiation	radiatsiya
radium	radiy
radioactivity	radioaktivlilik
radio	radiola
radiology	radiologiya
radio	radiosport
radio	radiostantsiya
radio	radiotehnika
rocket	raketa
mignonette	rezeda
core	öz
core	özek
self	özü
myself	özüm
yourself	özüñ
oneself	öz başına
council	keñeş
early	erte
early	ertece
foil	rapira
report	raport
race	ırq
refined	rafinirlev
refine	rafinirlemek
rachitis	rahit
rationalism	ratsionalizm
rationalization	ratsionalizatsiya
rubbing	türpü
rehabilitation	reabilitatsiya
reagent	reaktiv
reactionary	reaktsioner
reaction	reaktsiya
realism	realizm
reanimation	reanimatsiya
revanchism	revanşizm
revisionism	revizionizm
rheumatism	revmatizm
golden	sarı turup
register	registr
regulate	regulirlemek
reservation	rezervatsiya
reservoir	rezervuar
residence	rezidentsiya
resonance	rezonans
rating	reyting
riding	reytuz
racket	reket
reconstruction	rekonstruktsiya
record	rekordçı
recreational	rekreatsion
relaxation	relaksatsiya
relay	rele
relief	relyef
relativity	relâtivizm
remark	remarka
reminiscence	reministsentsiya
repair	tamir
repair	tamir etmek
renegade	renegat
Renaissance	Renessans
profitable	rentabel
profitability	rentabellik
radiography	rentgenografiya
röntgenoscopy	rentgenoskopiya
rheostat	reostat
wet	cibitmek
isinmek	tonmaq
cut	toramaq
tumble	tomalamaq
ski	taymaq
stand	turmaq
fifth	beşinci
sixth	altıncı
seventh	yedinci
eighth	sekizinci
ninth	doquzıncı
tenth	onuncı
suet	don mayı
breast	emşek
breast	kökrek
bucket	qopqa
fool	qabaqbaş
bald	toqur
private	repetitor
private	repetitorlıq
reply	replika
loudspeaker	reproduktor
resource	resurs
reflex	refleks
reflexology	refleksologiya
reflector	reflektor
reformatory	reformator
reformation	reformatsiya
review	retsenziya
receipt	retsept
bend	qayırmaq
bow	qambıraymaq
send	qaytarmaq
order	sımarlamaq
entertain	sıylamaq
gold	altın
wood	ağaç
eyelash	kirpik
kick	tepmek
check	teşkermek
bark	talamaq
rain	yağmur
bone	kemik
council	şura
times	sefer
conjointly	ortaqlaşıp
scar	yara
scar	yaralamaq
speaking	rupor
feed	aşatmaq
be	bolmaq
run down	camanlamaq
snack	qabınmaq
lacerate	cırtmaq
visit	qatnamaq
measure	ölşemek
puck	şayba
field	şampinyon
chess	şahmat
Swede	isveç
hall	şveytsar
Swiss	isviçriyalı
scale	şkala
school	mektep
curry	qırmaq
slag	şlak
shock	şok
chocolate	şokolad
shorts	şortı
highway	şosse
Scotland	İskoçiya
chauffeur	şoför
starling	sığırçıq
spar	şpat
spatula	şpatel
hip	şip
splint	şplint
sting	süngü
thing	şey
scum	köpük
noise	şamata
noisy	şuvultı
make noise	şuvuldamaq
chatter	şıtırdamaq
fast	vızlı
noisy	şamatalı
sock	çorap
put drops	tamızmaq
put	taşlamaq
blench	tartınmaq
touch	tiymek
endeavour	tırışmaq
stubborn	eriş
tulip	lale
tomato	domates
fork	çatal
cherry	kiraz
steppe	çöl
Denmark	Danimarka
bird	kuş
hot	issi
donkey	eşek
bull	tana
soldier	asker
interesting	acayip
January	yanvar
August	avgustos
October	oktâbr
December	dekabr
chief	şef
patronage	şeflik
act	şeflik etmek
sluice	şlüz
cord	şnur
silk	yipek
bride	kelin
grandchild	torun
pin	iyne
toy	teltigirşik
rack	tartma
mustache	mıyıq
chickpea	nohut
knucklebone	aşıq
burly	mazallı
quadrangular	dörtkül
repair	onğarmaq
whelp	qulunlamaq
Crimean Tatar	къ
cloud	bulut
morning	saba
era	çağ
Sweden	İsveç
trestle	talyar
mill	termen
thimble	oymaq
turkey	pepiy
chicken	perik
first	birinci
goose	qaz
sneeze	cütkermek
stubbornly	egeşmek
far	erek
declivity	eniş
carpetbag	ekme
yogurt	cazma
friend	kaday
can	gügüm
stewed	qoşap
barn	qaqra
ewer	quman
tobacco	tütün
perverse	akis
night	keşe
late	keş
flannel	kölek
lizard	kesquyruq
bridegroom	kiyev
cattle	tuvar
Romania	Romaniya
Saturn	Zual
Mercury	Utarit
Venus	Çolpan
Earth	Zemin
Mars	Merih
Jupiter	Müşteri
analysis	talil
basin	havuz
biology	ayatiyat
pomidor	pamidor
feudalism	derebeylik
firm	şirket
plants	nebatat
Frenchman	frenk
July	iyül
café	qavehane
commissariat	komissarlıq
composer	bestekâr
Crimean Tatar	Qırımtatarca
Crimean Tatar	Qırımtatar
reporter	mühbir
box	qutu
mathematician	riyaziyatçı
mathematical	riyaziy
mathematics	riyaziyat
absolute	mutlaqiyet
driver	aydayıcı
neutral	tarafsız
reformer	islâatçı
frog	baqa
hoary	qart
south	cenüp
north	şimal
fence	qora
ram	qoçqar
side	yaq
hedgehog	kirpi
grandmother	qartana
take away	alıp ketmek
him	oña
recover	yahşı olmaq
bon appétit	aş olsun
turn sour	ekşimek
food	aşhane
heavy	ağır
become	ağırmaq
so	aysa
a bit	azçıq
bow	bağ
find	yolunı tapmaq
liver	bağır
strengthen	pekitmek
bundle	boğça
be	olmaq
dog	küçelek
badihava	bedava
hail	burçaq
flea	bürçe
stick	yapışmaq
nude	çıplaq
beg	yalvarmaq
grey-haired	çalbaş
brother	qardaş
flat	yalpaq
discredit	yamanlamaq
patch	yamav
wake	uyanmaq
nap	yantaymaq
flaky	yantıq
make	yapmaq
close	qapatmaq
light	yarıq
hide	gizlemek
shawl	yavluq
shower	yağmaq
match-maker	quda
yogurt	yazma
fruit	yemiş
send	yibermek
fall	yıqılmaq
knock	yıqmaq
cry	ağlamaq
crybaby	ağlavuq
warm	isinmek
come	yılışmaq
warm	isitmek
hot	sıcaq
shine	yıltıramaq
bright	yıltıravuq
egg	yımırta
soften	yımşamaq
bitchy	yaramaz
lacerate	yırtmaq
fun	eglenmek
abhor	igrenmek
look in on	yoqlamaq
slender	ince
sticky	yuqmaq
walk	yürmek
docile	yuvaş
run	çapmaq
stubbornly	inatlamaq
breast	emçek
lazy	tenbel
lazy	erinçek
slender	cuqa
a bit	biraz
mould	ırımçıq
mould	küf
seal	sılamaq
plaster	sılav
trousers	ştan
pin	yine
snack	qapınmaq
how	nasıl
how	nasılsıñ
candy	qanfet
look at	baqmaq
swallow	qarılğaç
grandfather	qartbaba
doing	ne yapasıñ
colander	kevgir
young	kelinçek
late	keç
lizard	kesertki
coop	kümes
lock	kilitlemek
small	kiçkene
stewed	hoşaf
how	neday
how	nedaysıñ
majority	çoqusı
breast	köküs
shirt	kölmek
much	çoq
strange	hucur
west	ğarp
west	künbatı
navel	köbek
künçi	küncü
east	şarq
east	kündoğuş
bead	boyuncaq
paralysis	felç
step-	ögey
correct	tüzetmek
trivet	ocaq
bean	baqla
duck	papiy
chicken	ferik
oven	furun
you	saña
careful	saqt olmaq
mute	tilsiz
poor	fuqare
me	mağa
you	sağa
butter	sarı yağ
repair	tamirlemek
trousseau	ciyez
spill	sepelemek
grasshopper	çegertki
broom	sipirki
dinner table	sofra
earring	küpe
tent	çalaş
eave	saçaq
adept	çeber
bolt	çeklemek
sifter	çeltek
sift	çeltemek
flick	çertmek
untie	çezmek
ooze	çıbırmaq
chimney	boru
chick	çipçe
facial expression	çıray
crepe	çırlama
sledgehammer	toqmaq
short	çontuq
adze	çot
ladle	çomuç
hanger	çüy
shy	utançaq
stupid	sersem
thorn	tiken
traditional	tepreç
cut	doğramaq
brooch	tüyreviç
elder	üyken
wee	ufaq
wee	ufaq-tüfek
crumble	ufatmaq
Easter	Pashalya
wee	vaq
sovet	şuraviy
dishcloth	yuvğuç
animals	ayvanat
uncle	ağa
wrap	oramaq
jar	banq
owl	muratquş
owl	kökökmiyav
napkin	qolbez
glove	qolşaq
mother-in-law	qaynana
mother-in-law	qudanay
father-in-law	qudababay
father-in-law	qaynata
beetle	qoñuz
coffee table	kürsü
often	tınıştabır
so where's	qa
brood	balağa yatmaq
tally ho	mına
wherein	qayaqqa
altogether	zaten
especially	enqastan
usually	ziyadesinen
female	ırğaşı
soot	küye
anxious	qaarli
trouble	qaar
wheat	boğday
geography	coğrafiya
maternal aunt	tize
thistle	qamğaq
illness	maraz
garbage	kültöbe
hand	omaqa turmaq
right	oñ
betimes	erte-carıq
literary	edebiy
cloth	babaytop
meeting	toplaşuv
riddle	tapmaca
shadow	talda
shadow	kölge
pert	erke
lock	kirt
patience	çıdam
impatient	çıdamsız
party	qonaq
aeroplane	uçaq
estimable	sıylı
kittenish	ırcanke
coquette	yosma
new	yañı
new	cañı
fresh	taze
sport	qopuq
straw	toban
turtle	qapulbaqa
cow	sıyır
calf	bızav
gnat	çirkiy
angle	zaviye
aubergine	patılcan
racer	cüyrük
calculation	esap
gravy	sorpa
bolt	şek
house	qaraldı
difficult	qıyın
turn into	türlenmek
bear	tabmaq
masticate	çaynamaq
put	salmaq
wander	sandıraqlamaq
crack	sınmaq
stroke	sıypamaq
crack	sındırmaq
kill	soymaq
watch	siyretmek
take in vain	sögünmek
lengthen	sozmaq
piss	siymek
whistle	sızğırmaq
clump	üymek
drive	süyremek
sulk	muğaymaq
scratch	qaşımaq
petrified	qatıp qalmaq
scratch	qışımaq
bear	ballamaq
born	doğmaq
born	tuvmaq
ditty	şıñ
melt	irimek
absorb	suvurmaq
bear	doğurmaq
craze	esirmek
grub	eşmek
damn	qarğamaq
damn	kargamak
nip	şımtımaq
crash	sıtmaq
add	qoşmaq
rend	cırılmaq
double up	iyilmek
come together	tabışmaq
ascend	tırmaşmaq
thrust in	tıqmaq
initially	sipti
bathroom	amamlıq
bath	amam
garboil	aleket
uncle	emce
folk-song	yır
ditty	çıñ
few	azğana
very	birtalay
put to	cekmek
bran	kebek
rope	arqan
handlamp	fenerlik
bolt	tepki
phaeton	yaylı
fork	senek
scab	qotur
notebook	depter
door	qapı
wood	taqta
letter	mektüp
mirror	küzgü
fingernail	tırnak
mother tongue	ana til
dog	boşuq
dream	tîş
dream	tîş körmek
masticate	şaynamaq
run	şapmaq
burly	mazalı
again	kene
yeast	uytquş
sweet	qolaş
footwear	ayaqqap
sock	şorap
lamp	şıraq
pastry	qamıraş
noon	üyle
evening	aqşam
midafternoon	ekindi
real	aqiqiy
winter	qış
daytime	kündüz
owl	qoqokmiyav
lift	kötermek
cock	qoraz
happen	mezel
remind	ındemek
olive	ziytin
irascible	eserli
rotten	çürük
saliva	silekiy
saliva	salya
saliva	tükürşik
stubborn	ilez
bent down	iyik
cheap	ucuz
diarrhea	amel
expensive	paalı
starling	sıyırcıq
reach	irişmek
yahşı	eñ
saliva	tükürçik
cock	horaz
hall	qapıcı
shortening	qısqartma
show	köstermek
duty	vazife
write	yazmaq
agitate	qozğamaq
cup	filcan
beak	ğağa
pile off	tüşmek
moth	süme
across	kölderen
across	köndelen
bludgeon	köteklemek
sunflower	küntabaq
sunflower	şımışqa
fault	minsiz
laugh	külmek
smile	külümsemek
ice cream	dondurma
time	vaqıt
iron	temir
clothespin	qısqıs
all	episi
finally	niayet
anywhere	er yerde
entry	kiriş
animal	ayvan
crime	cinayet
sign	işaret
napkin	paçavra
shoe	pötük
sparrow	torğay
necklace	gerdanlıq
melon	qavun
swim	yaldamaq
luck	çast
origin	çoqraq
glory	maqtav
breakfast	sabalıq aş
snow	qar
sun	küneş
sand	qum
jail	apishane
signature	imza
vinegar	sirke
body	kevde
woman	apay
hawk	atmaca
word	söz
correction	tüzetme
foot	ayaq
trough	oluq
small	kiçik
Germany	Almaniya
crawl	baqalamaq
knot	tüyürçik
girl	qız
yours	siziñ
yours	seniñ
cheerful	şeñ
false	yañlış
push	iytemek
problem	mesele
oxidise	totlanmaq
example	misal
deride	mısqıllamaq
progenitor	ecdat
beggar	tilençi
schmooze	boşboğaz
cross	haç
quince	ayva
judge	kadi
example	örnek
monkey	şamek
mind	muqayt olmaq
pillow	yastıq
hook	ırğaq
hear	eşitmek
Byzantine Empire	Bizans İmperiyası
permanent	temelli
medlar	muşmula
джемаат	cemaat
country	memleket
user	qullanıcı
Russia	Rusiye
European Union	Avropa Birligi
letter	arif
Crimea	Qırım
Qırım	Qırım yarımadası
translator	terciman
translator	терджиман
return	avdet
avdet	авдет
Poland	Lehistan
state religion	resmiy din
wisdom	aqıl
France	Frenkistan
find	bulmaq
only	ancaq
make	qanmaq
scream	bağırmaq
steep	sarp
split	çatlaq
down	aşağı
paint	boyalamaq
Crimea	Къырым
republic	джумхуриет
strangle	boğmaq
World War II	Ekinci Cian cenki
cenki	Birinci Cian cenki
lose	coymaq
Къаракъалпакъистан	Qaraqalpaqistan
genitive case	-nıñ
tradition	anane
return	qaytuv
