elephant	sama
oil palm	teen
okra	gaan
lion	waraba
rice	malo
hippopotamus	mali
manioc	bananku
fonio	foni
raphia	baan
fatherland	faso
water	jí
sorghum	kende
date palm	tamaro
buffalo	sigi
village	dugu
animal	bagan
millet	ɲɔ
elephant	sogoba
perhaps	adɔrɔ
sky	alakolo
onion	alibasa
wheat	alikama
conversation	baabu
duty	baarada
riverbank	bakɔnɔ
fisherman	bamɔnna
fishing net	bamɔnjɔ
dawn	alifajiri
lake	banin
dew	gomiji
waterfall	jisuuru
young boy	bilakoro
boy	cɛmisɛn
son	dencɛ
taro	dandali
taro	mankani
zebu	gongan
zebu	tɛmɛ
leopard	waraninkalan
giraffe	wanjalaka
baboon	gɔɔn
