king	𒈗
in	𒀸
man	𒇽
city	𒌷
house	𒂍
father	𒀜𒋫𒀸
water	𒉿𒀀𒋻
mother	𒀭𒈾𒀸
god	𒅆𒍑
love	𒀀𒀸𒅆𒅀𒋻
who	𒆪𒅖
wood	𒋫𒀀𒊒
month	𒌚
fire	𒉺𒄴𒄯
not	𒈾𒀜𒋫
weighty	𒈾𒀝𒆠𒅖
wide	𒁄𒄭𒅖
man	𒁉𒌍𒈾𒀸
man	𒇽𒀸
hapax legomenon	𒈦𒄷𒌋𒉿𒅀𒀸
stick	𒉺𒄴𒄭𒅔
foot	𒄊𒀸
pa-ra-a-i	𒉺𒊏𒀀𒄿
wing	𒈦𒋫𒌋𒉿𒅈
wing	𒁁𒋻
give	𒉺𒀀𒄿
pé-eš-zi	𒁉𒌍𒍣
pé-eš-ši-ez-zi	𒁉𒌍𒅆𒄑𒍣
stone	𒉺𒀸𒅆𒆷𒀸
road	𒆜𒀸
big	𒊩𒇷𒅖
eye	𒃲𒄭𒀀𒅖
ša-a-ak-ki	𒊭𒀀𒀝𒆠
ši-i-ez-zi	𒅆𒄿𒄑𒍣
yoke	𒄿𒌑𒃷
sky	𒉈𒂊𒁉𒅖
evening	𒉈𒆪𒊻
heart	𒆠𒅕
cloud	𒀠𒉺𒀸
eagle	𒄩𒀀𒊏𒀸
behind	𒀀𒀊𒉺
goes	𒄿𒅀𒀜𒋫
river	𒄩𒉺𒀀
name	𒆷𒀀𒈠𒀭
be	𒂊𒌍𒍣
winter	𒄀𒈠𒀭
star	𒄩𒀸𒋼𒅕𒍝
daughter	𒁺𒌓𒋻𒊑𒅀𒋾𒅀𒀸
Mitanni	𒈪𒋫𒀭𒉌
night	𒅖𒉺𒀭𒍝
round	𒋻𒌑𒍣
tears	𒅖𒄩𒄴𒊒
wood	𒋫𒊒
place	𒁉𒂊𒁕𒀭
carriage	𒄭𒅖𒊭𒀭
see	𒌋𒄴𒄭
grandfather	𒄷𒄴𒄩𒀸
horse	𒀲𒆳𒊏𒍑
mouth	𒀀𒄿𒅖
breast	𒋼𒂊𒋫𒀭
soil	𒁍𒊒𒌓
new	𒉋𒀸
protect	𒉺𒄴𒊭𒊑
skin	𒆳𒊭𒀸
wine	𒃾𒅖
hide	𒌋𒆷𒂊
drink	𒂊𒆪𒍣
rescue	𒄷𒍑𒉡𒍣
live	𒄷𒍑
causative	-𒉡𒊻𒍣
fientive	-𒂊𒌍
burn	𒉿𒊏𒀀𒉌
ignite	𒉿𒅈𒉡𒊻𒍣
sprinkle	𒉺𒀊𒈦𒀸𒍣
you	𒍣𒄿𒅅
tribute	𒅈𒄰𒈠𒀸
instrument	𒆷𒀀𒀊𒉺
hound	𒆪𒉿𒀸
army	𒌅𒊻𒍣𒅖
earth	𒋼𒂊𒃷
man	𒀭𒌅𒉿𒄴𒄩𒀸
blood	𒂊𒌍𒄯
right	𒀀𒀀𒊏
friend	𒀀𒊏𒀸
Agni	𒀀𒀝𒉌𒅖
ar-aš-zi	𒅈𒀸𒍣
I	𒌑𒊌
fish	𒄩
god	𒋼𒊑𒀉𒋾𒌅𒌋𒉌𒅖
bread	𒃻
beard	𒍝𒈠𒀭𒆳
like	𒄿𒉿𒅈
meadow	𒌑𒂊𒂖𒇻𒍑
knee	𒄀𒉡
grass	𒌑𒂖𒆪
ice	𒂊𒃷
all	𒉺𒀭𒆪𒍑
message	𒄩𒇻𒅗𒀸
𒄿𒌑𒃷	i-ú-kan
queen	𒊩𒈗𒀸
Lesbos	𒆷𒊍𒉺
being	𒀀𒊭𒀀𒀭𒍝
master	𒅖𒄩𒀀𒀸
bear	𒄯𒁖𒂵𒀸
lower	𒃰𒋼𒊏𒀸
good	𒀀𒀸𒋗𒍑
king	𒈗𒍑
sheepfold	𒀀𒊭𒀀𒌋𒅈
wind	𒄷𒌋𒉿𒀭𒍝
every	𒄷𒌋𒈠𒀭𒍝
pregnant	𒅈𒈠𒌋𒉿𒀭𒍝
naked	𒉈𒆪𒈠𒀭𒍝
an-na-nu-zi	𒀭𒈾𒉡𒍣
send	𒅈𒉡𒊻𒍣
aš-ša-nu-uz-zi	𒀸𒊭𒉡𒊻𒍣
bloody	𒂊𒌍𒄯𒉡𒊻𒍣
bloody	𒅖𒄩𒉡𒉿𒀭𒍝
bloodied	𒂊𒌍𒄩𒀸𒃷𒍝
refuse	𒈪𒅎𒈠𒄿
an-ni-i-ez-zi	𒀭𒉌𒄿𒄑𒍣
a-ra-a-iz-zi	𒀀𒊏𒀀𒄑𒍣
a-ri-ez-zi	𒀀𒊑𒄑𒍣
oracle	𒅈𒄿𒅀𒀸𒌍𒊭𒅈
bone	𒄩𒀸𒋫𒄿
alive	𒄷𒅖𒉿𒀭𒍝
na-aḫ-ša-ar-nu-zi	𒈾𒄴𒊭𒅈𒉡𒍣
protect	𒉺𒄴𒄩𒀸𒉡𒊻𒍣
being	𒆠𒌍𒊬
find	𒌑𒂊𒈪𒄑𒍣
reverence	𒈾𒀝𒆠𒅀𒀀𒋻
small	𒄠𒈪𒅀𒀭𒍝
miniature	𒄠𒈪𒅀𒀭𒋼𒌍𒊬
e-ep-zi	𒂊𒅁𒍣
sleep	𒋗𒌒𒁉𒄑𒍣
cool down	𒄿𒂵𒀀𒄑𒍣
strike	𒉿𒀠𒄴𒍣
overpower	𒋻𒄴𒍣
when	𒆪𒉿𒁉
bloody	𒅖𒄯𒉿𒀭𒍝
mistress	𒅖𒄩𒀸𒊭𒊏𒀸
cord	𒅖𒄭𒈠𒀀𒀸
ki-i-ša-ri	𒆠𒄿𒊭𒊑
exempt	𒀀𒊏𒌋𒉿𒀸
sleep	𒋗𒌒𒉺𒊑
white	𒄯𒆠𒅖
high	𒈦𒆪𒍑
bad	𒄿𒁕𒀀𒇻𒍑
small	𒋼𒁍𒍑
all	𒁕𒀸𒋗𒍑
narrow	𒄩𒀜𒆪𒍑
name	𒇴𒉌𒄑𒍣
wool	𒋠𒀸
swear	𒇷𒅅𒍣
lick	𒇷𒅁𒍣
lick	𒇷𒉺𒀀𒄑𒍣
dawn	𒇻𒊌𒅗𒊑
set fire	𒇻𒊌𒆠𒄑𒍣
bad	𒄿𒁕𒀀𒆷𒌑𒌍𒍣
fientive	-𒌍𒍣
eat	𒂊𒄑𒍝𒊍𒍣
ḫu-u-ni-ik-zi	𒄷𒌋𒉌𒅅𒍣
word	𒈨𒈪𒅀𒀸
anger	𒋼𒀀𒁲𒈪𒅀𒊍
netherworld	𒋼𒂊𒈾𒌋𒉿𒀸
third-person	-𒀸
death	𒄭𒅔𒃷
virgin	𒋗𒌒𒁉𒌍𒊭𒀸
old	𒈪𒅀𒄷𒉿𒀭𒍝
impure	𒉺𒀊𒊏𒀭𒍝
sharp	𒀠𒁍𒍑
poor	𒀀𒅆𒉿𒀭𒍝
where	𒆪𒄑
thus	𒆠𒅖𒊭𒀭
now	𒆠𒉡𒌦
cold	𒂊𒆪𒈾𒀸
flower	𒀀𒇷𒂖
