descend	kita
with	na
father	tata
speak	loba
there	kuna
boron	bolo
bínó	bo-
of	ya
now	sika
thin	tunga
sew	tonga
write	koma
here	áwa
mother	mamá
coffee	kafé
person	moto
scrape	kosa
firstborn	bola
water	mái
bicycle	veló
he	yě
Africa	Afríka
nitrogen	azoti
titanium	titani
paste	mwǎmba
God	Nzámbe
pineapple	ananási
they	bangó
baptism	batísimo
cough	kɔsúkɔsú
you	bínó
bus	bísi
we	bísó
side	epái
far	mosíká
vegetable	mfúmbwa
key	fungóla
semolina	fufú
cassava	mpɔndú
outside	libándá
cricket	likélélé
noise	makɛlɛ́lɛ
slowly	malémbe
cold	malíli
bad	mabé
earth	mabelé
milk	míliki
pain	mpási
I	ngáí
woman	mwǎsí
hunger	nzala
house	ndáko
vegetable	ndúnda
peanut	ngúba
ox	ngɔ́mbɛ́
pig	ngúlu
animal	nyama
palm	mbíla
fly	nzinzi
fish	mbísi
wet	máimái
table	mésá
elder	yayá
father	tatá
fetus	zémi
idiot	zóba
bag	sáki
sandal	sapáto
lithium	litu
take	kamata
front	bosó
baldness	libata
support	sanga
proclaim	sakola
carbon	kaboni
game	lisano
bromine	bomo
married	bála
liver	libale
ice	galási
only	káka
selenium	seleni
neon	neoni
baldness	libandi
arsenic	aseni
indium	indu
sodium	sodu
love	linga
argon	alago
obtain	zwa
honey	bói
die	kúfa
palm	likata
meeting	likita
river	ebale
leader	mokonzi
city	mbóka
termite	mondɔngɛ
tree	mweté
soldier	sodá
lie	kósa
gallium	galu
angle	mbata
sorcerer	ndɔki
crocodile	ngandó
monster	elímá
sadness	mawa
be	zala
blood	makila
together	elongó
sun	mói
rather	ndé
right now	sikoyo
this	óyo
song	nzémbo
for	mpó
all	nyɔ́nsɔ
also	lokóla
head	motó
little	mokɛ́
authority	bokonzi
above	likoló
other	mosúsu
ballpoint pen	bíkí
one	mɔ̌kɔ́
heart	motéma
road	nzelá
machine	masíni
period	mobú
period	eleko
office	biló
bath	báfu
ball	bále
bank	bánki
poor	mobóla
dance	bobína
marijuana	bángi
naivety	búbá
color	lángi
operation	likela
west	límbe
marriage	libála
bread	límpa
misfortune	libábe
obstacle	libakú
duck	libáta
viper	libáté
spoon	lútu
leprosy	maba
also	mpé
owner	nkóló
obey	tósa
prayer	losámbo
ring	lompɛ́tɛ́
see	mɔ́nɔ
do	sála
rejoice	sepela
give	pésa
type	loléngé
sin	lisúmu
go	kɔ́tɔ
universe	mokili
leaf	lonkásá
five	mítáno
four	mínei
three	mísáto
two	míbalé
six	motóbá
seven	nsambo
eight	mwambe
nine	libwá
ten	zómi
ten	lotúkú
slave	moúmbu
news	nsango
go	kɛndɛ
front	libosó
time	ntángo
wisdom	bwányá
build	tónga
protector	mobáteli
stand up	tɛ́lɛmɛ
pray	bóndela
prayer	libóndeli
stretch	límba
forgive	límbisa
reign	konza
milk	mabɛ́lɛ
whole	mobimba
discipline	pámela
declare	tatola
youth	bolɛngɛ́
problem	likambo
read	tánga
law	mobéko
throat	mongóngó
night	butú
if	sɔ́kí
believe	ndima
send	tínda
paint	kóba
lesson	litéya
messenger	ntóma
designer	moyémi
earthenware	mbɛ́ki
let	tíka
need	sengela
thin	tungisa
ask	túna
explain	yanola
escape	bíka
save	bíkisa
gorilla	mpumpu
blessing	lipamboli
dog	mbwá
skin	monkandá
comfort	bomɛngɔ
lack	zánga
righteousness	boyengebene
friend	moníngá
teacher	molakisi
fat	mafúta
goat	ntaba
book	búku
inside	káti
you	yɔ̂
child	mwǎna
breast	libɛ́lɛ
god	nzámbe
chicken	nsósó
bean	lidɛ́su
open	fungola
ant	monsɔ́mbɛ
palm nut	lobíla
true	sɔ̂lɔ́
eggplant	sɔ́ló
big	monɛ́nɛ
long	molaí
short	mokúsé
twin	lipása
wing	lipapú
sun	mwésé
wind	mompɛpɛ
rain	mbúla
today	lɛlɔ́
black	moyíndo
urine	masúba
ear	litói
ear	likútu
whip	fímbo
tooth	lǐno
eye	lǐso
box	sandúku
chair	kíti
beard	mandéfu
sleep	lála
meet	kúta
gun	bondóki
eyeglasses	manɛ́ti
a lot	míngi
open	zibola
hello	mbɔ́tɛ
fish	samáki
cross	kurúzɛ
bed	mbɛ́to
nose	zólo
mud	pɔtɔpɔ́tɔ
not	tɛ́
cup	kɔ́pɔ
pig	ngulúbɛ
vagabond	shégé
Democratic Republic of the Congo	Kinsásá
man	mobáli
it	yangó
sing	yémba
conversation	lisoló
talk	solola
monkey	makáko
steal	yíba
thief	moyíbi
eat	líya
drink	mɛlɛ
adjacent	lóbí
ginger	tangaúsi
plate	sǎni
younger	lɛ́ki
road	nzilá
leg	lokolo
Kituba	kitúba
Swahili	kiswahíli
arm	lobɔ́kɔ
Democratic Republic of the Congo	Mbándáká
Democratic Republic of the Congo	Matádi
Democratic Republic of the Congo	Kimwénza
Kongo	kikɔ́ngɔ
feather	lonsálá
shame	nsɔ́ni
tongue	lolémo
pond	liziba
egg	líki
charcoal	likála
leopard	nkɔi
hippopotamus	ngubú
skin	lomposo
life	bomɔi
Lingala	lingála
French	lifalansé
French	falansé
cat	nyáu
dugout	bwáto
boat	masúwa
bee	nzói
elephant	nzɔku
snake	nyóka
lion	nkɔ́si
bone	monkúwa
finger	mosapi
doctor	mónganga
rice	lɔ́sɔ
tobacco	likáyá
beauty	kitɔ́kɔ
goodness	malámu
flag	bɛndɛ́lɛ
bullet	lisási
soap	sabúni
sanza	likembé
disease	maláli
window	lininísa
coffee	káwa
servant	bɔ́i
tent	éma
even	atâ
perfume	malási
sugar	sukáli
horse	farása
rudeness	yaúli
sandal	eláto
thread	búsi
cowpea	nkúnde
close	fúnga
cannabis	diámbá
beginning	ebandeli
mouth	monɔkɔ
what	níni
who	náni
how	bóní
where	wápi
stone	libángá
street	balabála
metal	ebendé
food	biléi
bottle	molangi
doctor	dɔkɔtɔ́lɔ
driver	sofɛ́lɛ
darkness	molílí
prison	bɔlɔ́kɔ
