parrot	dodo
mother	mama
water	tuna
cry	amo
within	aka
worm	motto
jaaja	jaja
tree	dee
ju	juu
aaki	aki
middle	annai
tear	ishi
ocean	dama
jaana	jana
sky	kaju
so'to	sotto
bird	jawi
blood	munu
salt	sayu
smoke	eima
come	e'
jyunu	junu
enter	omon
child	nne
green	sheene
beverage	kushi
bamboo	daju
sand	saa'da'da
mountain	jüü
island	dantadü
cave	ewüütü
mountain	jidi
lake	chuu'jö
waterfall	yedukadü
forest	chuuta
stone	tö'ju
earthquake	dejuushi
sun	shii
moon	nuunö
star	shidiichö
wind	jejeenchö
cloud	kaa'dutu
rain	konoojo
fire	waa'to
fire	dudiinñü
smoke	widiinchö
ash	wedeennö
cassava ash	shee'se'dü
burn	ukaa
burn	ya'kwa
slash-and-burn	ya'ka
burn	da'twa
light	kemetö
match	tüsochaamü
man	danwa
woman	wodi
boy	mudeköökö
boy	danwa'kö
adolescent	mudeeshi
girl	wodi'chö
husband	ñno
mother	denü
brother	nuwaa
younger brother	shii'chü
younger brother	yaakoono
older sister	yaaya
grandfather	kooko
grandmother	tamuu
old woman	no'samo'kü
grandchild	jaadü
uncle	woodü
maternal uncle	yawo
aunt	wainñe'nei
nephew	jonü
niece	jaase
female cousin	yaa'ko
father-in-law	woodüümö
son-in-law	kömusa'kö
son-in-law	kön'kwö
orphan	tun'kemjünü
family	jimmö
pig	kuushi
hen	kudaimaadu
chicken	wameedi
duck	jaatu
yadanawi	jañudu
jañudu	yadanawi
nest	danñami
heron	tadaaya
heron	maadi
great egret	ajiisha
eagle	demooshi
hawk	jiyaana
vulture	kuduumu
orange-winged parrot	kudeewa
kaichai	kai'chai
kai'chai	kaichai
dove	jaduuma
dog	süü'na
cat	meeshi
opossum	dawaade
mouse	asüükü
fish	naakukwaano
fish	na'kwakano
fish	o'taajo
lion	kawadiimö
bear	jödeemu
fox	awadudi
deer	kawaadi
yadakadu	yadaakadu
yadaakadu	yadakadu
louse	daamö
scorpion	münöötö
spider	modoi
bee	wannö
wasp	suunwa
fly	wedeesede
ökkööyu	ökööyu
snake	ökkööyu
snake	tadaadweemö
matutu	matuutu
matuutu	matutu
grasshopper	küdatai
snail	memu
tree frog	kütto
turtle	je'de
skin	ji'jö
junu	jyunu
head	juu'jö
juu'jö	ju'jö
beard	ettömujo
aki	aaki
ye'jö	yee'jö
yee'jö	ye'jö
tail	daa'küdü
je'dü	jedü
jedü	je'dü
forehead	je'kai
eye	önu
jana	jaana
nose	önna
mucus	önu'tö
mouth	önta
ö'ji	öö'ji
öö'ji	ö'ji
tongue	ñuudu
tooth	dedü
jümü	jüümü
jüümü	jümü
shoulder	nkawö
arm	a'jö
elbow	öö'mu
amö	amoo
amoo	amö
fingernail	ömmi
leg	jeetü
calf	joode
foot	juudu
wing	ajö'sai
feather	i'joo'tü
chest	doo'ta
breast	'dojü
heart	yeewanü
lung	'tawai
stomach	duduunoi
jöttü	jyootü
jyootü	jöttü
cough	töinshi'jo
vomit	wena'tajö'e'nö
bite	eekaadü
sleep	wünü'nö
sleep	ünükü
dream	wöneetünö
birth	ennu
life	wenñö
aminñö'ka	aminña'ka
aminña'ka	aminñö'ka
weak	aa'kedeeto
healthily	tadöinñe
swelling	awonñö'kaadü
swell	awoo
dream	wöneetü
cure	adonka
medicine	öji
tired	tükincha
rest	wöödeetanö
rest	öödeeta
lame	sekumje
o'doku	o'do'jö
o'do'jö	o'doku
o'doku	ö'daku
God	Wanaadi
Wanaadi	kajunña
in	-nña
father	jaaja
Odo'sha	Kajuushawa
Wanaadi	Odo'sha
laugh	wa'senño
love	jumma
love	jyumma
love	jummadü
love	jyummadü
sad	wentumje
lie	enkutö
rifle	adakusa
good	ashicha
bad	kone'da
ugliness	könemjünü
ugliness	konemjünü
beautiful	inñataje
war	wönö
fight	ötöönejaa
fight	wötöönejaanö
axe	wüüwü
arrow	shimaada
spear	sukuji
spear	yaichadü
fishhook	anöötö
fishnet	anötö
fishnet	ja'ji
hunt	emanñujü
shoot	üwöö
trap	jaano
village	ja'ta
people	wei'chü
chieftain	ödaajö
friend	weichakoono
enemy	tu'de
meet	edantö
voice	kö'tünnö
sing	ekantaa'ñö
sing	etanta'ñö
shout	kö'tün
word	a'deu
speak	a'deuwü
tell	mee'ku'töö
language	aa'deu'kwe
ask	ekammajo
request	e'katö
name	töötü
paper	jajeeda
flute	jiichu
flute	jiichü
think	tütajö
believe	ekanüjü
learn	oowanoma
teach	owaanoma
teacher	yowaanomani
school	woowanomatojo
yes	'eee
yes	mmjm
no	mm'jm
type	aadajadaduwa
eat	owashiinchö
food	muduukuku
redden	seeweicha
red	seweiche
rotten	chöötaajö
drink	enku
lie	enku'tö
hungry	ömiije
hungry	amiije
cook	a'nö
pot	ödinñö
pot	jadankaana
pan	'tadii
knife	kümü'kö
meal	öwainshi
peel	i'sha
stir	oima
potato	shaaku
flower	chööjüdü
fruit	chööjüdüüjüdü
fat	kaatü
chili pepper	jomi
egg	i'moi
Odo'sha	Kajuu
put on	ewontö
clothing	womü
cotton	wadeekuu
weave	tü'ka'jüdü
sew	shooka
needle	makuusa
thread	jakuudimü'tü
collar	woo'mo
adornment	sawiiya
bracelet	ajö'müi
bead	mayuudu
mirror	jekuude
house	mmaa
house	nma
yard	jüdoodo
yard	jüdödö
room	ö'sa
door	münaatata
wall	jö'judu
ladder	inñaju'tajö
bench	aa'töi
bench	muude
table	mesai
torch	adaawa
roof	amö'jüdü
board	tadwa
garden	audwaajö
dig	ü'kaa
dig	üka
seed	chööju'jö
crop	inñatü'töödü
maize	önña
maize	anña
manioc	ai'chü
leaf	yadü
tobacco	kawai
manioc	küdeede
gourd	kankudu
sugarcane	öshiichaadü
sugarcane	ashichadü
rope	aa'to
loincloth belt	'ya'müttü
help	'wa'tö
verbs	-'se
also	-'na
make	tüdüü
tool	tüdüütojo
work	tadawaaju
tie	imü
tie	wiñüi
tie	sheicha
cut down	chuujiya
break	ishicha
break	eshichako
tear	eshi
hang	ewa'tö
squeeze	e'kukaa
sweep	sheemeka
wash	icho'ka
wash one's hands	onwatüü
wash	entatüü
wash	inchatüü
basket	wüüwa
fan	wadiwadi
bodypaint	waanai
paint	wemaan'a
paint	wanaichö
wrap	wemöiiya
rise	önu'k
fall	eduka
throw	jimaa
sink	yeju'kwai
float	tütaawa'ta
bathe	tüwö'jiyü
swim	jönün
blow	yaichumaa
blow	udee
jump	ajanün
dance	önwa
walk	oojoyma
walk	ii'chöödü
run	eka'tün
go	wü'töö
climb	annu'ku
descend	jü'wakaadö
exit	eja'ka
return	ennakaa
flee	öönejee
pursue	aje'ka
arrive	ö'dü
carry	adöö
bring	enejü
push	adima
road	ööma
canoe	kanowa
paddle	jeena
harbor	wö'tö
take	emjan
grasp	ahöi
give	utuudu
save	ewanakaa
survive	wööwanakanö
seek	ujiiyü
lose	önnanü'
pay	ejeema
sell	ejemajoi
through	-joi
negotiate	ötö'tijaa
negotiate	ötötija
so'to	ssoto
also	yö'jöje
beside	dü'tö
below	do'nö
high	kawö
before	owaajo
first	awa'de
serve	a'ka
among	anwa'ka
high	kawöö
sit	atajjimaa
separate	shaadamadüüje
divide	yaatojötü
low	nonojo'chö
top	akoi'cha'jüdü
bottom	nwa'köi
edge	chö'jiyu
