one	ğ„‡
two	ğ„ˆ
three	ğ„‰
four	ğ„Š
five	ğ„‹
six	ğ„Œ
seven	ğ„
eight	ğ„
nine	ğ„
ten	ğ„
twenty	ğ„‘
thirty	ğ„’
forty	ğ„“
fifty	ğ„”
sixty	ğ„•
seventy	ğ„–
eighty	ğ„—
ninety	ğ„˜
one hundred	ğ„™
two hundred	ğ„š
three hundred	ğ„›
four hundred	ğ„œ
five hundred	ğ„
six hundred	ğ„
seven hundred	ğ„Ÿ
eight hundred	ğ„ 
nine hundred	ğ„¡
one thousand	ğ„¢
two thousand	ğ„£
three thousand	ğ„¤
four thousand	ğ„¥
five thousand	ğ„¦
six thousand	ğ„§
seven thousand	ğ„¨
eight thousand	ğ„©
nine thousand	ğ„ª
ten thousand	ğ„«
twenty thousand	ğ„¬
thirty thousand	ğ„­
forty thousand	ğ„®
fifty thousand	ğ„¯
sixty thousand	ğ„°
seventy thousand	ğ„±
eighty thousand	ğ„²
ninety thousand	ğ„³
total	ğ™‚ğ˜
