bear	mapa
wave	вата
saw	по-
earth	на
inside	до
hut	кава
liver	па
floor	palan
sledge	пара
stone	kadar
good	aya
I	ми
you	си
rich	баян
this	эй
time	эр
fire	тава
brother	ага
price	таман
grouse	поро
tree	мо
today	эйниэ
yesterday	чисэниэ
hard	манга
head	дили
whale	калима
liver	paa
insect	колан
old man	мапа
far	горо
hundred	танго
no	ана
blood	сэксэ
pine	дягда
branch	гара
who	уй
world	яло
autumn	боло
Siberian salmon	дава
goat	иман
fish	имаха
vinegar	чу
nose	вакса
three	илан
father	ама
poison	гу
blind	бали
other	гой
aspen	поло
black	сахарин
warm	няма
candle	ла
swan	куку
deer	орон
porridge	балан
twenty	хорин
inundation	далан
gate	дока
place	боа
move	ди-
bow	бури
healthy	ая
horse	морин
clear	галга
cloth	босо
color	бойко
saw	пори
what	хай
fox	соли
eagle	гуси
spear	гида
flea	сора
column	тора
oat	муди
pants	пэру
horn	хуе
water	муэ
man	най
lacrimal sac	покон
nest	омо
breast	кун
crow	гаки
seven	надан
flour	опа
mist	tamna
dust	бурэхи
lower lip	пэмун
fish	холто
beaver	тарга
snake	муйки
snow	симана
egg	омокта
cloud	тэвэксэ
needle	xurmä
wind	xädun
hammer	палоа
shoulder	муйрэ
lake	амоан
spider	атакан
ear	сиан
bear	наӈи
onion	элу
sleeve	хуэксэ
rust	сэптучэ
medicine	окто
host	эден
squirrel	хулу
oar	гиол
maple	гинэлэ̄н
maple	бултухэ
maple	монон
maple	мокчохали
many	эгди
throw	наӈгала-
give	бӯ-
send	уйгу-
boat	огда
horse	mürïn
rain	тугдэ
frost	туӈдэ
sea	namü
meat	уликсэ
eye	насал
hat	а̄пон
do	аӈго̄ри
morning	чими
word	хэсэ
lynx	тугде
winter	туэ
tongue	сирму
mouse	šiŋgärä
street	гиан
heart	миаван
end	дуэ
eight	žïakpün
four	дуин
gold	ayšïn
wolverine	айло̄ки
sleep	а̄ми
night	dülbü
rabbit	токса
wolf	нгэлэ
bird	гаса
animal	бэюн
animal	усэлтэ
fox	солаки
wolf	енгур
insect	хунгули
ant	силуктэ
goose	нёнгня
thirty	гочин
dragon	мудур
cranberry	гакта
sleep	ами
larch	пиа
hair	šïŋakta
nose	хоӈко
forest	пурэн
child	пиктэ
tooth	xuktä
book	daŋsa
paper	хаосан
town	хотон
hat	а̄пока̄н
bread	эпэн
fish	согдата
frog	хэрэ
donkey	эйхэ
white	чагдян
pine nut	бокто
beard	гогакта
silk	гокси
name	гэрбу
roof	гуичэ
seal	гиокса
dawn	гиван
heron	вачака
face	дэрэл
nephew	бэнэр
animal	бэйӈэ
taiga	дуэнтэ
wing	дэктэчэ
cow	ихан
arrow	лэкэ
catfish	лаха
foundation	тэхэ
door	уйкэ
bucket	муэлу
otter	муэду
end	модан
kidney	босокто
enter	и-
dream	толкин
ten	žüan
nine	хуюн
six	нюңгун
five	тойңга
rain	tugdä
wife	ašï
ice	žukä
word	xäsä
squirrel	xulu
sword	lüxü
woman	äktä
foot	bägži
elder sister	ägä
scale	däŋsä
breast	tuŋgän
wing	xasar
niece	gamasün
niece	piktärän
autumn	bülü
harpoon	žügbü
sickle	xadükü
cloth	büsü
salt	daüsün
carp	xaŋgü
crow	türakï
net	aŋga
far	gürü
shawl	puŋku
brook	üňïkan
drug	üktü
soot	guluxin
sail	kütülï
treasure	žaka
woman	gïrsü
band	ümü
thief	čüwü
together	kamür
thin	nämdäkän
place	büa
hand	ŋala
bitch	wäčän
mouth	aŋma
fish skin	sügbü
nail	tukpä
water	muä
bitter	güčïšïï
lightning	agžï
tail	xuygu
hole	saŋar
he	ňüanï
large sturgeon	ažïn
ancient	balapčï
man	bäyä
aspen	pülü
two	žuär
grass snake	žabžan
cedar	küldün
turtle	kaylan
walnut	küčüa
stone	žülü
nose	waaksa
turtle	аян
day	ини
husband	эди
stone	дёло
time	эрин
when	хали
immediately	машан
dumpling	бианси
throat	билга
voice	дилган
cat	кэксэ
nose	опоро
gun	миочан
carpenter	модян
key	анако
money	диха
boat	тэмтэкэн
scorpion	цэнки
ink	мошуи
gold	бобой
floor	палан
taste	амтан
fog	тамна
mind	мурун
sheep	хонин
one	эмун
iron	сэлэ
hear	долди-
shoulder	нгуйрэ
forehead	пэе
camel	тэмэн
stork	уйгун
palm	пайнга
foot	бэгди
body	бэе
live	би-
moon	биа
we	буэ
do	ангори
mouth	ангма
wife	аси
year	айнгани
sleep	ао-
thunder	агди
bitter	гочиси
together	камор
cedar	колдон
plate	котан
crow	тораки
raven	холи
hole	сангар
lung	хэутэ
hand	нгала
ice	дюкэ
upper	увуй
mother	энин
nail	хосакта
dog	инда
long	оними
dark	пакчи
you	суэ
mountain	хурэн
heavy	хуйгэ
tail	хуйгу
melt	ун-
Russian	лоча
front	дюлуй
thousand	минган
elbow	хуйчэн
navel	хуйму
birch	пиагдан
book	дангса
button	тохон
tin	тохолгон
run	туту-
salt	даосон
scales	дэнгсэ
bitch	вэчэн
thin	нэмдэ
poppy	даян
river	мангбо
way	покто
lower	пэгуй
breast	тунгэн
scythe	хадоко
wing	хасар
sister	эгэ
fur	сингакта
how many	хадо
woman	эктэни
stream	оникан
thief	чово
žabžan	дябдян
object	дяка
light	нгэгден
low	нэктэ
cannon	пао
thick	буйгу
roe deer	гиу
bone	гирмакса
ask	гэлэ-
eat	деп-
liquor	араки
see	ичэ-
there	чала
chin	сэсхэ
thick	дирами
inner	довой
fly	дэгдэ-
write	нирури
generation	дялан
summer	дёа
house	дё
he	нёани
laugh	инэктэ-
sun	сиун
tasty	амта
left	деги
up	уйси
grass	паякта
sole	палган
window	пава
craftsman	пакси
grouse	пиму
woodpecker	пилакта
saw	попон
shave	посири
razor	посико
light	пудэн
blow	пу-
barley	пуди
wound	пуе
knee	пэйнгэн
west	пэрхи
green	нёнгиан
red	сэгден
old	сагди
pig	олгиан
swallow	лунгбэ-
drill	лунгу
place	бэун
frame	бэрэн
swamp	нярон
drink	оми-
light	хэню
blow	пиуги-
lamp	ихэрэ
young	наондёан
silver	мэнгун
Chinese	никан
fat	симуксэ
swim	паори-
kill	ва-
bathe	элбусири
sing	икэрэ-
step	гиран-
deep	сонгта
dense	лугди
feel	уйнгэ-
nail	тукпэн
fir	вангта
fir	хасикта
soup	чолон
brother	нэил
spring	ненгне
hang	локта-
courtyard	тулиэ
side	холдон
high	гогда
brain	игэ
hair	нуктэ
forward	дюлилэ
go out	ниэ-
bottom	пэрэл
uncle	эчэкэ
uncle	гусин
wall	падиран
skin	хэрэктэ
lizard	исэлэн
dew	силэмсэ
then	тэли
louse	чиктэ
swim	онёан-
hollow	онголо
hemp	онокто
forget	онгбо-
stocking	доктон
sister	нэку
son-in-law	аоси
brother-in-law	кэли
smoke	сангнян
island	боачан
wasp	девэн
saliva	дилокса
eyelash	сармакта
fly	дилуэктэ
lie	делэн-
flower	силакта
bile	силтэ
milk	сири-
belly	хэмдэ
wait	халачи-
tendon	сумул
sew	улпи-
wet	чакпа
ancient	бапапчи
hot	пэку
sand	сиян
tomorrow	чимана
dig	хулэ-
feed	ули-
spin	томпо-
put	нэ-
cold	гичиси
short	хурми
cover	бури-
tobacco	дамахи
form	дурун
first	бонго
hump	букун
lazy	албакто
teach	алоси-
straight	тонгдо
dry	холгокто
dry	холго-
cold	нонгди
weep	сонго-
wash	силко-
fear	нгэлэ-
sharpen	сули-
sharpen	пивэ-
follow	даха-
breath	эриэн
small	нучи
good	улэн
thigh	талпи
destroy	хэпулири
win	хэтэри
swell	хаоло-
know	отоли-
puncture	локпа-
stand	или-
tie	сопсин-
vomit	хусэри
scar	калхин
flow	хэери
cut	муи-
return	мочого-
knead	монгичи-
split	дэлки-
seed	усэ
front	дюлиэ
grow	урэ-
be born	балди-
spit	силпон
spit	топин-
sit	тэси-
open	нихэли-
hold	туру-
hit	дуктэ-
ash	пунэктэн
back	дарама
branch	сукту
husband	эды
intestine	пухин
leaf	хабдата
fruit	амтака
mosquito	гармакта
neck	монгон
root	дачан
rope	соптанги
ash tree	сивагдан
crown	чимчикэн
pinecone	сиучихин
cone	чимчиктэ
blanket	полта
news	мэдэ
moss	нямолта
bird	ниэчэн
top	порон
load	тэучи-
shallow	харба
snow	симата
shadow	сингмун
spear	сугбэ
tale	нингман
two	дюэр
lead	тодя
pitch	нутэ
twin	адо
black birch	дивэгдэн
sword	лохон
crooked	мокчо
legend	тэлунгу
yellow	согдён
big	даи
hawk	гихон
sable	сэпэ
kingfisher	судуй
owl	оксаран
kite	пичуэн
female	асиа
copper	гион
people	гурун
seal	дорон
blade	дее
dive	пурин-
cut	гири-
lick	илэури
monkey	монён
army	чаоха
row	мэлбири
hang	локтаори
dung	амон
reach	исири
splash	писири
charcoal	сиалта
rabbit	гормахон
cut	муири
crumb	пурумсэ
creep	муйкури
boil	пуйсири
rib	хэучилэ
open	нихэлири
go out	ниэри
silk	сэурэ
soap	мэлэ
fiend	амбан
finger	чумчуэн
earthworm	пэнтэ
draw	илгалаори
bite	сиаори
bathe	элбусиури
laugh	инэктэури
burn	дегдэури
drink	омиори
take	гаори
go	энэури
die	бурбури
give	бувури
kind	хачин
