four	pat
water	bru
dessert	samo
pangolin	arem
fruit	bua
weave	tenun
path	dalan
water	nanum
turtle	penu
west	ɖaya
eel	tula
water	ənay
woman	babayan
doctor	ising
pineapple	panguzaɭ
conceal	vuɭi
airplane	hikuki
planet	sinciw
transport	akutr
owner	tawki
hair	arebu
sky	langitr
