net	ami
meat	beat
volleyball	bari
younger	agi
foreleg	caw
stone	alibi
ash	abu
bow	bu
fart	bira
if	ana
seed	cape
father	ama
cooking	agama
why	aasi
adulteress	cepa
father	tama
more	aru
can	alu
semen	bulu
cooked	aga
alcoholic	bava
black nightshade	amici
earth	dae
fishnet	arai
originally	alaka
antenna	antina
pork	arici
grape	budu
amen	amin
raincoat	cabale
duck	bibi
wound	dula
possibly	alasi
madake	cepe
male	bucu
salt	timu
button	ciki
cheek	cimi
fig	dena
beer	bire
eel	tula
enemy	badha
ouch	anana
smell	bangere
grandchild	agane
preaching	dindu
woman	Ê”avai
foxtail millet	abai
fish	kange
fire	apwi
bottle	bingi
hair	isiw
cartilage	berebere
yellow	buraw
poison	duku
vegetable	damay
feces	caki
dove	punai
telephone	dingwa
temple	biw
heart	avava
cloud	ememe
leader	tamatama
oil	abera
weave	tinono
organization	dantay
owner	tawki
small intestine	buuru
bento	bintu
table	cukwi
dove	tavagu
woman	ababay
bat	ababiraw
ant	ababungu
spirit	abake
dirt	abulruku
tadpole	acacere
gift	acebe
water	aciladhane
paddy	aciacilay
bird	adhadhame
iron	adreme
inside	adringi
game	agase
cupboard	airaze
mercurochrome	akacingki
wedding	akagami
monster	akema
shadow	alalingu
wasp	alalipiri
insect	alalubai
shield	alathare
bark	aleale
tip	alikay
cowlick	alipugu
female	alisu
swallow	alralrakici
fly	alralregele
flesh	alralrangaw
wasp	alralucu
hand	alrima
sleeve	alrimane
stone	alrisapesape
egg	alrisese
sour	maalriw
heel	alrudrudrane
nasal	alulu
candy	alwalu
hawk moth	amamirungu
rainboot	amigece
Amis	Amizuku
who	aneeane
tree	angatu
lingzhi	tharikangatungatu
pain	angeange
pipe	angucu
poisonous	apapase
locust	apapawku
crab	apase
rice	apilrici
solider	apudru
light	twapwi
winged	araradray
aluminium	aremi
alcohol	arukuru
gravel	arululane
larva	arupipi
little	asane
ladder	asigu
pestle	asulru
cockroach	atatabange
liver	athai
skylight	athaw
cogon grass	awbu
head	awlru
iron	ayrungu
monosodium glutamate	azinumutu
ceiling	baaliali
monkey	babila
pig	babwi
nasal	baeke
syphilis	baiduku
lake	baiyu
dagger	bakale
firecracker	bakeci
bomb	bakedange
tree	bakuru
bamboo	balebale
Elaphe	balawlatwane
wall	balingibingi
rainbow	balrilawlaw
horsepower	balriki
house	balriw
one	balrulane
Boletus	baluthiluthi
stuffy	bangete
priest	barakalay
abdomen	barange
giant roundworm	barathare
shotgun	baratama
sand	barase
lily	bariangalai
hole	barungulu
sneeze	basenge
location	basiw
bump	batekale
cheekbone	bathingi
battery	batilri
egg	batuku
hulled	becenge
pig	beeke
banana	belebele
culture	benka
tribe	berake
small	bereke
sibling	betakane
stomach	bicuka
handbag	bidhulu
wave	bikabiki
behind	bilrili
squirrel	bubutu
wild	bulabulai
flute	bulalri
seedful	tucaecape
top	belenge
swamp	beneke
springwater	berai
fine	bisaw
sound	bitabiti
hospital	biwingi
hindleg	bubwane
vertebra	bukulu
pastor	bukusi
boxing	bukusingi
pork	butulu
paddy	caane
patient	caeme
virus	caemane
Bombax ceiba	calrathay
ear	calringa
rope	calrisi
single	calruru
person	kiacapili
giraffe	carakicaki
pellet	cariathe
roof	cavalri
year	cayli
every	caycayli
arrow	cekese
bronchus	cekeraw
earwax	celege
drought	cengelraw
idiot	ciangelrane
strength	cikara
pickled	cikimunu
xiangqi	cikiwku
gramophone	cikungki
poinsettia	cilabelabe
insect	cilameke
toilet paper	cilrigami
throat	cilulrane
ringing	ciringi
sugar cane	cubusu
sugar cane	cacubusan
woodpecker	cucugu
turtle	cukucuku
hunchback	cukulu
bone	culrale
Chinese	culraculru
bear	cumay
popcorn	curucuru
injection	cwiki
house	daane
sigh	daange
index finger	dadiputhane
banyan	daralape
radish	daykungu
carpenter	daykusange
explosive	daynamay
baby	dayni
buttocks	dekele
small	didilrungu
automobile	didiwsa
rust	dilange
earthen	dilrungu
preacher	dindusi
snail	dingidingi
telephone	dinva
spleen	dipilay
camphor tree	drakese
dance	dralrai
sword	dramu
betel	drangaw
foot	drapale
oak	drathiri
warehouse	drawsulu
thunder	dreredrere
trap	dringai
electricity	dringiki
Japan	Dripungu
bog	dulraki
cooked	dwu
pig	dwuthu
sky	subelebelenge
juice	esebe
light	ethethenge
blood	eray
sand	enay
maggot	ekai
breast	thuthu
water	acilay
new	bavane
