root	abut
we	ami
turn	see
Tetun-Terik	bee
tree	ai
country	rain
forest	alas
pull	dada
chew	mama
big	boot
rice	hare
excrement	teen
eat	han
bottom	hun
bone	ruin
bamboo	au
not	la
narrow	kloot
dead	mate
put	tau
eel	tuna
man	mane
fish	ikan
stink	foo
mango	haas
spleen	ook
bird	manu
rope	tali
horse	kuda
defecate	tee
iron	besi
scoop	suru
bite	tata
pencil	lapis
scale	kiki
he	nia
five	lima
descend	tun
we	ita
sun	loro
letter	surat
lipstick	baton
come	mai
nine	sia
fault	sala
boat	ró
go	bá
do	halo
chop	taa
leaf	roo
bee	bani
oil	mina
English	inglés
body	aan
who	sé
two	rua
cut	tesi
butter	manteiga
seed	fini
hour	tuku
shark	uu
English	Inglés
old	tuan
they	sira
count	sura
fire	ahi
father	aman
kill	oho
louse	utu
rice	etu
tribe	suku
dog	asu
aroid	talas
urine	mii
turn	fila
kitchen	dapur
banyan	hali
again	fali
leg	ain
scratch	koi
burn	sunu
male	manen
you	imi
tea	xá
woman	feto
market	basar
penis	uti
cook	nasu
sharp	kroat
sick	moras
forbid	bandu
enter	tama
hunt	kasa
hot	manas
orange	sabraka
Tetum	Tetun
person	ema
crocodile	lafaek
house	uma
street	lurón
field	to'os
field	kampu
milk	susubeen
rural	Tetun-Terik
coffee	kafé
beer	serveja
indigenous arrack	tua
bread	paun
meat	na'an
salt	masin
sugar	masin-midar
sweet	midar
sweet potato	fehuk-midar
fruit	ai-fuan
rice	foos
yawn	maas
chocolate	xoklate
money	osan
paper	surat-tahan
car	karreta
school	eskola
market	merkadu
hospital	uma-moras
hospital	ospitál
shop	loja
shop	toko
you	ó
I	ha'u
high	aas
church	kreda
wind	anin
split	fera
wool	lan
vomit	muta
cat	busa
mind	noin
buy	sosa
one	ida
sweet potato	uhi
four	haat
deer	rusa
ashamed	moe
pound	fai
square	prasa
coal	anar
bury	taman
black	metan
white	mutin
pestle	alu
skin	kulit
bake	tunu
firearm	kilat
suck	susu
wide	luak
needle	daun
top	tutun
can	bele
swell	bubu
fry	sona
sail	laan
arrow	hana
live	moris
tie	kesi
hide	subar
what	sá
word	lia
cockroach	barata
smoke	fuma
hand	liman
eye	matan
pot	sanan
blow	huun
son	oan
throw	soe
give	fó
liver	aten
be	iha
mouse	laho
voice	lian
hill	foho
straight	loos
fruit	fuan
banana	hudi
coconut	nuu
pineapple	ananás
pineapple	ai-nanás
width	luan
Estonia	Estónia
wash	fase
navel	husar
fat	boran
breadfruit	kulu
sea	tasi
night	kalan
measure	sukat
tear	luun
sneeze	fani
foreign	malae
dry	maran
flow	suli
year	tinan
window	janela
sour	siin
butterfly	borboleta
serpent	saa
tie	futu
tree	-hun
flame	lakan
wart	futi
language	dalen
worm	ular
hide	heli
hear	rona
cheese	keiju
hurl	tuda
as	komu
fart	hosu
run	halai
forget	haluha
old	ferik
layer	taan
bottom	kidun
swallow	tolan
lake	rebu
red	mean
ripe	tasak
lap	hitin
open	loke
pigeon	falur
hard	toos
goat	bibi
taste	tamis
squeeze	buti
way	dalan
table	meza
lie	toba
vein	uat
far	dook
beat	baku
fragrant	morin
difficult	susar
maize	batar
rice paddy	natar
lightning	mamera
marriage	kaben
split	fota
left	karuk
smell	horon
short	badak
mother	inan
steam	suar
sit	tuur
wealthy	riku
calf	fitis
flight	semo
wet	bokon
dam	batak
fall	monu
bell	sinu
knife	tudik
pick	hili
ear	fulin
moon	fulan
rainbow	baur
cloth	hena
how many	hira
drip	turu
thing	buat
drink	hemu
still	dauk
sulfur	baliran
sing	nanu
blood	raan
top	leten
female	feton
hole	kuak
love	domin
bad	aat
wife	feen
taste	furak
widowed	faluk
scissors	kateri
swim	nani
rain	udan
Asia	Ázia
blow	huu
hold	kaer
thin	mihis
govern	ukun
flower	funan
mushroom	kulat
know	hatene
octopus	kurita
hundred	atus
flap	tahan
name	naran
cotton	kabas
pay	selu
thick	mahar
follow	tuir
armpit	kalilin
hunger	hamlaha
yesterday	horiseik
tail	ikun
wish	karak
waist	kanotak
yam	kumbili
dust	ahun
unripe	matak
cry	tanis
tooth	nehan
hunger	laha
dream	mehi
point	tudu
wine	tuaka
all	hotu
wake	fanun
belly	kabun
package	falun
dig	ke'e
fly	lalar
shirt	kamiza
quality	kualidade
new	foun
poor	kiak
breast	susun
father-in-law	banin
cloud	kalohan
spoon	kanuru
brain	kakutak
nest	knuuk
nail	pregu
bark	hatenu
apple	masán
ant	nehek
book	livru
penis	lasan
saliva	kabeen
neck	kakorok
shoulder	kabaas
kid	labarik
hair	fuuk
tale	nanun
wisdom tooth	nehan-kraik
church	uma-kreda
basement	uma-kidun
hut	uma-tali
eave	uma-tatiis
restaurant	uma-han
skull	ulun-ruin
headache	ulun-moras
crown	ulun-fuhur
scalp	ulun-kulit
sheep	bibi-malae
rifle	besi-ahi
steel	besi-asu
perfume	bee-morin
swamp	bee-moris
barber	barbeiru
pig	fahi
tuber	fehuk
lord	na’i
thought	hanoin
speak	ko'alia
day	loron
low	kraik
ear	tilun
nose	inus
eaves	tatiis
crown	fuhur
cook	da'an
back	kotuk
ten	sanulu
twenty	ruanulu
thousand	rihun
love	hadomi
price	folin
star	fitun
stone	fatuk
nail	kukun
right	kuana
walk	la'o
afraid	ta'uk
breath	nawan
tongue	nanal
see	haree
help	tulun
say	ha'ak
steal	na'ok
good	di'ak
morning	dadeer
tell	dehan
go up	sa'e
write	hakerek
laugh	hamnasa
spit	tafui
stand	hamriik
sell	fa'an
cook	te'in
grass	du'ut
inside	laran
egg	tolun
elbow	sikun
war	funu
top	fohon
wall	didin
calf	ain-kabun
hair	fulun
vulva	hu'in
snout	inur
long	naruk
sugar cane	tohu
chin	timir
knee	ain-tuur
small	ki'ik
heavy	todan
certain	tebes
dirty	fo'er
rotten	dodok
yellow	kinur
turmeric	kunir
old	katuas
close	besik
other	seluk
this	ne'e
husband	la'en
branch	sanak
ash	kadesan
fog	abuabu
lightning	rai-lakan
mosquito	susuk
mouth	ibun
sky	lalehan
thunder	rai-tarutu
noise	tarutu
smoke	ahi-suar
lemon	derok
forgive	perdua
grapefruit	jambua
Christian	sarani
interpreter	durubasa
live	horik
bile	horun
column	riin
