goat	ጤል
banana	ሙዝ
water	ማይ
trousers	ስሬ
porcupine	ቅንፍዝ
sheep	በግዕ
coffee	ቡን
greeting	ሰላም
name	ስም
head	ረኣስ
hand	እዴ
blood	ደም
ox	ሶር
dog	ከልብ
sun	ሸምሽ
heart	ልብ
mouth	አፍ
hyena	ዝብኢ
evening	ምሴት
ear	እዝን
peach	ኮክ
fire	እሳት
sword	ሰይፍ
bear	ድብ
father	አብ
father-in-law	ሐም
book	ክታብ
from	ምን
handmaid	አመት
sun	ጸሓይ
tail	ዘነብ
flag	ባንዴራ
drum	ከበሮ
fig	በለስ
universe	ዓለም
foot	እግር
trousers	ሱሪ
the	ለ-
milk	ሐሊብ
almond	ለውዝ
barley	ስገም
crown	አክሊል
die	ሞተ
camp	ዕርዲ
giraffe	ዝዖታ
giraffe	ዘራፍ
colt	ምህር
bovine	ቴተል
antelope	ገርወ
antelope	አራብ
arrack	አረቂ
klipspringer	አምበርሀጋ
asafoetida	እማት
asafoetida	ዐባይ
rifle	መክሕል
corn	ሞግያ
rifle	መንዱቅ
mountain plum	ምልሕጣ
yesterday	ማሌ
tick	ቀራድ
spider	ሳሬት
goat	ነገል
whip	ክርባጅ
long	ሐነጅ
calf	እግል
gallnut	አፈስ
time	ዘበን
butter	ዝበድ
beat	ዘብጠ
stroke	ዘብጥ
bowl	ደምቦ
basket	ጀንቢል
back	ዝባን
side	ገቦ
fundament	አንገብ
village	አንግብ
bone marrow	እንግዖ
corn	እክል
polenta	እከለት
abdomen	ሕምስ
nightshade	ዕንግል
potato	በጣጢስ
potato	ድንሽ
pharmacon	ደዋ
bridle	ልጋም
crupper	ዘናብ
ginger	ዝንጅብል
nettle	ሳማ
chickling vetch	ሰበሬ
herb	ሰዐር
incense	ዕጣን
perfume	ዕጥር
incense	ልባን
tamarisk	ዖበል
fillet	ለበት
crown	ታጅ
sirloin	ተድዕ
rope	ተዶብ
citron	ትርንጎ
bitter apple	ዐንደል
this morning	ቀለስ
today	ዮም
fodder	ምክላት
new	ሐዲስ
renew	ሐደሰ
former	በዲር
frontlet	ጋሜ
now	አዜ
military rank	ኣውጂ
bean	አደንገል
mustard	እድር
fester	በጊላ
gonorrhoea	በጀን
hide	ገኖ
Paradise	ጀነት
hemp	አንጀባ
maize	ዕፉን
barley	ሽዒር
durra	ማሼላ
oats	ሰዐዕ
Gyps africanus	ጋም
lacking	ገመ
wheat	ሽርናይ
in	እት
back	መቅጠን
caltrop	ቅጠብ
fruit	ከባሽ
mallow	ቅናጦል
pocket	ጂብ
nose	ኣንፍ
sposh	ለብዕ
mendication	ልማኖ
petroleum	ለምባ
lemon	ሎሚን
date	ተመር
palm	ረሐት
fragrant	ርሓን
open	ረሓ
sausage	ዕሽቢሎ
sack	ዐሺነት
beer	ስልቃ
soap	ሳቡን
henna	ሕና
maternal uncle	ሓል
sister	ሕት
which	አዪ
thus	ክት
window	ሽባክ
cattle	ምግዳ
gnat	ጻጾት
ant	ጻጼ
pomegranate	ሮማን
float	ረመስ
skiff	ሰንቡቅ
steamboat	ባቡር
small	ዝዒመት
rowing boat	ፍሉካ
boat	ሆሪ
plant	ዕርብ
layer	ዕራይ
death	ሞት
rifle	በንቱን
flag	ቤረቅ
anchor	ብሮሲ
belly	በርሰት
lentil	ብርስን
tobacco	ትምባክ
love	ፍቲ
love	ፈታ
torch	ፋኑስ
shit	ሐርዐ
shit	ሐርዕ
grape	ወይኒ
grape	ዕነብ
to	ዲብ
wine	ነቢት
neighbour	ጎር
near	ጎ-
and	ከ-
snake	ሐበ
berry	ሐበት
desert candle	ቅልንቃል
stone	እብን
tin	ገስጢር
ladder	ሰሎም
dill	ሺላን
patten	ቅረቃብ
placenta	ስሌት
write	ከትበ
small	ክታበት
track	ክተብ
instruct	አክተበ
write	ከታተበ
vaccinate	ካተበ
scribe	ከታብ
year	ዓመት
year	ሰነት
bowels	አምዒት
intestine	ምዖ
Juniperus procera	ጽሕዲ
mule	በቀል
broad bean	ባቄላ
throat	ወሪድ
turn	ውርድ
dried	ወርድ
