remember	จับ
rib	กก
superhuman	ซีดี
go	ปี
cooked	นาซี
mother	มะ
six	นัม
color	ซี
candle	แดด
pliers	คีม
hat	โมะ
lung	เซาะ
one	ซา
rattan	วี
father	ปะ
sweets	โกย
plate	ยับ
fishbone	แคะ
hammer	คอด
washing powder	แฟบ
know	ตาฮู
exist	อาดา
at	เดะ
jackfruit	นากา
horizontal	ซีตา
foot	กากี
eye	มาตา
wood	กายู
prawn	ฮูรัก
nail	กูกู
ghost	ฮาตู
ear	ตลีงา
cry	มือนาแงฮ
deep	ดาลับ
day	อารี
fault	ซาละฮ
forest	ฮูตัด
stingray	ปารี
dog	อาซู
wolf	อาซู ฮูตัด
sail	ลายัล
reach	ฮาดะ
fish	อีกัด
choose	ปีเลฮ
fowl	ฮายับ
deaf	ตูลี
veins	อูรัยจ
sea turtle	เปอญู
oil	มีญะ
finger	ยฺารี
life	ฮีโดะ
body	ญาวา
language	พาซา
parade	แฮ
monkey	กรา
cooked	มาซะ
rib	โกก
give	บรี
brave	บรานี
field	ปาดัก
jungle	ปารัก
crocodile	บาฮายา
chisel	ปาฮัจ
ground	ตานะฮ
desert	ปาดัก ตานัฮ
road	ยฺาลัด
man	อูรัก
sea	ลาโวยจ
worship	เซอมะฮ
stomach	โปรยจ
tree	ปูโฮด
face	มูคา
winnow	ตาปิฮ
share	ปาฮาฆิ
side	รูโซะ
two	ดูวา
three	ตีกฺา
four	ปัยจ
five	ลีมา
seven	ตูโยฺะฮ
eight	ลาปัด
nine	เซอมีลัด
ten	เซอปูโละฮ
shrine	บาลัย
country	นังกฺรี
world	ดือนียา
world	เบอนัว
wind	อาแงน
needle	ยฺารบ
god	ตูฮัด
fire	อาปี
water	อาเย
moon	บูลัด
fur	บูลู
bad	ยฺาฮัยจ
liver	ฮาตี
leaf	ดาโวด
burn up	ตูนู
blood	ดาระฮ
eat	มากัด
egg	เตอเลอ
handle	ฮูลู
nose	ฮีดก
rain	ฮูยฺัด
profit	อูตก
bear	บรูวัก
fish trap	บูบู
age	อูมอล
unhusked	ปาดี
husked	บรัยฮ
black	ฮีตับ
tiger	บรูตัด
pig	บาบี
wild boar	บาบี ฮูตัด
animal	เบอนาตัก
book	ซูรัยจ
sky	ลาแงะ
white	ปูเตะฮ
yellow	กูนิง
year	ตาฮด
cow	เลอมู
fly	ลาเงา
durian	เดียด
bee	มาทู
mosquito	ญาเมาะ
hand	ตางัน
centipede	ลีปัด
give birth	ดูโดะ เดะ อาปี
banana	ปีซัก
sit	ดูโดะ
ring	จีเจด
hairclip	พาเพะ
bucket	ทก
djenkol	เชอนีง
rabbit	เคอนัม
tooth	กฺีกฺี
film	ฟีม
shellfish	ซีโปยจ
basket	รากฺา
theater	วายัก
boat	ปราฮู
eggplant	ตรก
glass	เจรอเมน
acne	ยฺราวัยจ
lemongrass	ซรัย
lamp	ปลีตา
coconut	กลาเม
shark	ฮยู
hawk	ฮลัก
mouth	มูโลยจ
house	รูมะฮ
cat	เมียว
betel nut	ปีนัง
squirrel	ตูปัย
cleaver	ตาแมะ
monitor lizard	แกฺรก
tail	อีเกอ
spider	กฺาวะ
mosquito net	กามุง
kettle	ตีกอ
strait	ลัวะ
wave	อูมะ
bird	บูรก
crab	เกอตับ
cake	เคก
betel nut	งาจิ
house gecko	จะจะ
intestinal	จะจิก
comb	ซีเซ
spoon	ซูดู
chin	ดากฺู
broadcast station	ทานี
radio	ทาโยะ
custard apple	นูนัง
lip	บีเบ
cheek	ปีปี
island	ปูเลา
Facebook	เฟด
fireplace	กรัด
water buffalo	เกรอเบา
duck	อีติ
hair	โบะ
heart	ยาตก
Buddhist	วัยจ
citrus fruit	ลีเมา
pumpkin	กันตูกัน
sweet basil	เจอมางี
whale	ฮยูเบอเซอ
papaya	ตีมอนกายู
cucumber	ตีมอน
chevrotain	ปลาโนะ
nest	ซารัก
tortoise	กูรา
radio	ทายุ
apple	แอบเปิน
Phuket	ตอกคา
coffee	กูปี
bait	อูปัด
hornbill	กาแคก
man	เซอมียา
voice	ซาวารา
leech	มราตะ
diaper	ปราปิ
clay	เจรอปู
maize	ยาโกฺะ
hill	บูเกะ
seerfish	เตอกฺีรี
open sea	อารอก
salt	กฺารับ
grass	รูโปยจ
sugar cane	เตอบู
Phi Phi	บรีบรี
bar	บูเลอ
crow	เดอนัก
hill	บูกิ
like	ซูกา
send	อาตัยจ
forget	ลูปา
speak	เมอเลา
compete	บลูมา
listen	มรีงัย
dance	ยฺัวะ
run	บารี
thin	นีปิฮ
market	เกอดัย
anchor	ซาโวะฮ
get	เบอเละฮ
wait	นาตี
come	มาแระฮ
return	บาลิ
stop	ซีงะฮ
move	เบอกฺาญะ
ascend	ญาแญะ
be	ยฺาดี
wear	เบอปากัย
be	ตาโกยจ
hear	เดอเงอ
tell	ญาแระ
wipe	ซาปัก
be	เปอจะฮ
Lipe	ปูเลานีปิฮ
start	รูมด
noise	บูงี
feel	บราซา
money	ตัง
flying fox	ละอูละ
quick	บางัยจ
red	มีระฮ
sun	มาตาอารี
large	เบอเซอ
before	ดูลู
also	ยฺูกฺา
if	กาเลา
wife	บีนี
bay	เตอโละ
mist	กาโบยจ
star	บีตัก
hot	ฮางัยจ
paddle	งาเญาะฮ
hand net	ญาเวาะ
goat	แบะ
good	บายฺิ
thunder	กฺูเตอ
rock	บาตู
yet	ลากฺี
husband	ลากี
promontory	ตาญก
horse	กูดา
trawl	ปูกัยจ
coconut	กาเม
coffee	โกปี
chest	ดาดา
cry	นาแงะฮ
ask	ตาญา
child	นานะ
squid	นุยฮ
thing	บารัก
flower	บูงา
head	ปาลา
rambutan	ราโมยจ
chili	ลาดา
root	อาเกอ
snake	อูเลอ
reef	การัก
gust	รีโบยจ
night	มาลับ
style	จารา
cicada	อูแยะ
giant	กฺาซี
middle	เตองะฮ
tomorrow	มะฮปากฺี
food	ลาโวะ
thud	พลอก
gargle	มูมู
do	บวยจ
lie down	ตีโนะ
think	อีงัยจ
look	ลัยจ
cold	เบอแยะ
no	เตด
morning	กฺีปากฺี
morning	ปากฺี
spirits	อาระ
bamboo	บูโละฮ
sail	ลาเยอ
nail	ซีปากู
pillow	บาตัน
sleeping mat	เลอปัยจ
take	อาเมด
ladle	เซอโนะ
bowl	บาเตน
knife	ปีเซา
coconut cream	ซาตัด
float	ฮาญอยจ
bowl	มาโกะ
charcoal	ฮารัก
asparagus bean	กาจักปาญัก
bean	กาจัก
long	ปาญัก
fruit	บูวะฮ
color	จัยจ
navel	ปูซัยจ
bone	ตูลัก
waist	ปีงัก
throat	เบอเกฺาะ
elbow	ซีกู
shoulder	บาฮู
arm	เลองัน
tongue	ลีดะฮ
benzoin	เกอเมียน
anything	นามา
anyone	ซาปา
water	เยฺรา
palm	กูเมอ
plank	ปาปัด
tie	อีกัยจ
knee	ลูโตยจ
string	ตาลี
dust	ฮาบู
convey	เปอโดะ
stretch out	ตูโฮะ
ronggeng	รูเงก
village	ตูโปะ
grandfather	แจ
just now	ซีงี
salty	มาเซด
cloth	กาเยด
twelve	ดูวาเบอลัยฮ
twenty	ดูวาปูโละฮ
forty	ปัยจปูโละฮ
thirty	ตีกฺาปูโละฮ
thirteen	ตีกฺาเบอลัยฮ
fourteen	ปัยจเบอลัยฮ
fifteen	ลีมาเบอลัยฮ
sixteen	นัมเบอลัยฮ
eighteen	ลาปัดเบอลัยฮ
nineteen	เซอมีลัดเบอลัยฮ
seventeen	ตูโยฺะฮเบอลัยฮ
fifty	ลีมาปูโละฮ
sixty	นัมปูโละฮ
seventy	ตูโยฺะฮปูโละฮ
eighty	ลาปัดปูโละฮ
ninety	เซอมีลัดปูโละฮ
hundred	ราตุยฮ
eleven	เซอเบอลัยฮ
artificial	การักเทียม
doctor	บูมอ
boat	ลูนัยฮ
divide	พากฺิ
pineapple	นังนัยฮ
bicycle	แระกฺีแระ
cloud	กอมมวง
woman	นีบีนี
corrugated iron	ตีมะฮ
Urak Lawoi'	อูรักลาโวยจ
beautiful	เบอกาจะ
shallot	บาวักมีระฮ
garlic	บาวักปูเตะฮ
grasshopper	บาลัก
earthen	กฺูรี
sugar	กฺูลา
mango	มาจัก
buy	เบอลี
fishhook	มาตากาเยน
fishing line	กาเยน
mud	ลูเปอ
hungry	ลาเปอ
turmeric	กูเญะ
turmeric	กูแญะ
make	บูริ
story	ลากฺู
cut down	บาโฮะ
parcel	บูกุยฮ
candle	จูโจะฮ
betel pepper	ซีเระฮ
cut off	ปูตุยฮ
rebana	บานา
drum	ปาลู
throw out	ซูวัยจ
licuala	ปาลัยฮ
upper	อาตัยฮ
because	ซาเบะ
bottle	บูลี
together	ปาคัยจ
group	ลูเมาะฮ
Urak Lawoi'	ลูเมาะฮลาโวยจ
old	ตูฮา
skin	กูเละ
amusing	รามัย
puffed rice	เกอมัก
wax	ลีเลด
west	บารัยจ
span	เดอปา
ask for	มีตา
fishnet	ยาลา
loudspeaker	ลัมโพง
type	เกฺอนัก
firstly	ลามูลา
mark	ตานา
olden	นูตู
droplet	พุพุ
coconut	งารอยจ
into	เบาะฮ
needle	โจะบัด
already	ดะฮ
wire	ดาวัย
concern	ดูลี
money	ดูเวะ
done	ฮาบิฮ
not	ฮอย
look	ลีฮัยจ
litre	ลิด
powdered	ลูมัยจ
sour	มาซับ
uncooked	มาตะฮ
young	มูดา
tasty	ญามัน
type	ญาโตะ
married	นีกะฮ
indication	เปอนานา
door	ปีตู
calm	เซองะ
vegetable	ตาโระ
east	ตีเมอ
north	ตารา
close	ตูดก
close	ตูโดก
follow	ตูโรยจ
time	วะตู
smoke	อาซะ
sift	อีริ
with	ซามา
see	กฺารี
content	อีซี
angle	ซากฺี
be	ราซา
traditional	ปาจัก
curved	ปีเกาะ
look for	มียา
in unison	มาเรอมา
beach	ปาตัย
flag	เกฺอนีรา
have	ฮวยจ
protection	พาดัก
out	เจอบุ
hut	ซาเราะ
iron	อาเยน
iron	เบอซี
doctor	บูมอล
dance	ตารี
read	บาจา
love	ซายัก
diamond	อีตัด
thunder	กฺูตล
pestle	ฮาลู
cottonwool	กาปัยฮ
bow	ปานะฮ
spread out	อาเปอ
spread out	อาปัล
